AAAAAAAATAGCAGATAAG->AAAAAAATAGCAGATAAGT
AAAAAAATAGCAGATAAGT->AAAAAATAGCAGATAAGTA
AAAAAATAGCAGATAAGTA->AAAAATAGCAGATAAGTAT
AAAAAGGGCCACTGTCCAT->AAAAGGGCCACTGTCCATC
AAAAATAGCAGATAAGTAT->AAAATAGCAGATAAGTATG
AAAACATAATGTGGTATAC->AAACATAATGTGGTATACA
AAAAGGGAACTCTAGCTTG->AAAGGGAACTCTAGCTTGA
AAAAGGGCCACTGTCCATC->AAAGGGCCACTGTCCATCA
AAAAGTCCAAGGTTTGTGA->AAAGTCCAAGGTTTGTGAC
AAAATAGCAGATAAGTATG->AAATAGCAGATAAGTATGC
AAAATGCATGAGATTACCG->AAATGCATGAGATTACCGC
AAAATTTCCCAGGGTCTTA->AAATTTCCCAGGGTCTTAT
AAAATTTCGAGAGGCATGA->AAATTTCGAGAGGCATGAC
AAACAGTAGGAATGTTTGG->AACAGTAGGAATGTTTGGT
AAACAGTGGATAGATGCGG->AACAGTGGATAGATGCGGA
AAACATAATGTGGTATACA->AACATAATGTGGTATACAC
AAACGGAATCTGGACTGAT->AACGGAATCTGGACTGATT
AAACGGCAACTCCCCTCTC->AACGGCAACTCCCCTCTCT
AAACTAAAAGTCCAAGGTT->AACTAAAAGTCCAAGGTTT
AAAGCCAAGTTTCACTACC->AAGCCAAGTTTCACTACCG
AAAGCCCCCTGTTGAGAAC->AAGCCCCCTGTTGAGAACC
AAAGGGAACTCTAGCTTGA->AAGGGAACTCTAGCTTGAT
AAAGGGCCACTGTCCATCA->AAGGGCCACTGTCCATCAT
AAAGTAACGGGGAAGGAGA->AAGTAACGGGGAAGGAGAG
AAAGTATTTCATTGCGGTG->AAGTATTTCATTGCGGTGG
AAAGTCCAAGGTTTGTGAC->AAGTCCAAGGTTTGTGACT
AAATACTATCGCCCGAGGG->AATACTATCGCCCGAGGGG
AAATAGCAGATAAGTATGC->AATAGCAGATAAGTATGCG
AAATCACGACCGCAGCTAA->AATCACGACCGCAGCTAAC
AAATCATTCCACCGATAGC->AATCATTCCACCGATAGCG
AAATGCATGAGATTACCGC->AATGCATGAGATTACCGCG
AAATGCGAGGGAAAGTAAC->AATGCGAGGGAAAGTAACG
AAATGGTCAATTAATCTCG->AATGGTCAATTAATCTCGG
AAATTACTGTCAACTGTAT->AATTACTGTCAACTGTATG
AAATTATAGAGCCTCGTCC->AATTATAGAGCCTCGTCCA
AAATTTAGTTGGTAACGTA->AATTTAGTTGGTAACGTAT
AAATTTCCCAGGGTCTTAT->AATTTCCCAGGGTCTTATA
AAATTTCGAGAGGCATGAC->AATTTCGAGAGGCATGACA
AACAACCAATAATGTATAA->ACAACCAATAATGTATAAG
AACAACTGGTAAAGCCCCC->ACAACTGGTAAAGCCCCCT
AACACGACAGCGGGCATCT->ACACGACAGCGGGCATCTC
AACACGTTAAGGTTGCCGT->ACACGTTAAGGTTGCCGTA
AACACTGTATTCTCGATGG->ACACTGTATTCTCGATGGT
AACAGTAGGAATGTTTGGT->ACAGTAGGAATGTTTGGTC
AACAGTCAGCAAAACATAA->ACAGTCAGCAAAACATAAT
AACAGTGGATAGATGCGGA->ACAGTGGATAGATGCGGAC
AACATAATGTGGTATACAC->ACATAATGTGGTATACACC
AACATACGCCATATGGTCG->ACATACGCCATATGGTCGC
AACCAATAATGTATAAGAG->ACCAATAATGTATAAGAGA
AACCACAGTGTGACGAAAA->ACCACAGTGTGACGAAAAA
AACCCTTTTGGTCCTTATG->ACCCTTTTGGTCCTTATGA
AACCGCCCCACTGGTGGCC->ACCGCCCCACTGGTGGCCA
AACCTCAGAGTCGGTACCC->ACCTCAGAGTCGGTACCCC
AACCTGACAGCTGTTCTGC->ACCTGACAGCTGTTCTGCG
AACGAACCCTTTTGGTCCT->ACGAACCCTTTTGGTCCTT
AACGACAGGAATCACGACC->ACGACAGGAATCACGACCG
AACGATTACAATATGCGAA->ACGATTACAATATGCGAAA
AACGCGGAACTCGCGAACG->ACGCGGAACTCGCGAACGA
AACGCTTATTGCCTCACCC->ACGCTTATTGCCTCACCCG
AACGGAATCTGGACTGATT->ACGGAATCTGGACTGATTT
AACGGCAACTCCCCTCTCT->ACGGCAACTCCCCTCTCTA
AACGGGGAAGGAGAGACTA->ACGGGGAAGGAGAGACTAG
AACGGGGCTACATCTCCCA->ACGGGGCTACATCTCCCAG
AACGTATCGCCTGATACTA->ACGTATCGCCTGATACTAG
AACGTCTCAGTAGAGTTTG->ACGTCTCAGTAGAGTTTGC
AACTAAAAGTCCAAGGTTT->ACTAAAAGTCCAAGGTTTG
AACTAATGGCATAGTCATG->ACTAATGGCATAGTCATGA
AACTAGCGTCAGGCGGCAC->ACTAGCGTCAGGCGGCACT
AACTCCCCTCTCTATTTTA->ACTCCCCTCTCTATTTTAG
AACTCGCGAACGATTACAA->ACTCGCGAACGATTACAAT
AACTCTAGCTTGATCCAGG->ACTCTAGCTTGATCCAGGC
AACTGGTAAAGCCCCCTGT->ACTGGTAAAGCCCCCTGTT
AACTGTATGCTAAATTTAG->ACTGTATGCTAAATTTAGT
AACTGTATTTAGGTGCTCC->ACTGTATTTAGGTGCTCCT
AACTTCAGGTACTGTTCTG->ACTTCAGGTACTGTTCTGG
AACTTTCCCAGGGCTCCAG->ACTTTCCCAGGGCTCCAGG
AAGACCGGAACGCTTATTG->AGACCGGAACGCTTATTGC
AAGAGACTAGGCCATAGCT->AGAGACTAGGCCATAGCTC
AAGAGCCAGTCCACTGATC->AGAGCCAGTCCACTGATCC
AAGAGGCTCTCATTAATTA->AGAGGCTCTCATTAATTAT
AAGATAAGGGGCGACCTGG->AGATAAGGGGCGACCTGGC
AAGATGTACGTTCTTACTC->AGATGTACGTTCTTACTCG
AAGCACCACCGTTATTTCC->AGCACCACCGTTATTTCCA
AAGCCAAGTTTCACTACCG->AGCCAAGTTTCACTACCGC
AAGCCCCCTGTTGAGAACC->AGCCCCCTGTTGAGAACCT
AAGCCTTAAGGCTGGCCGA->AGCCTTAAGGCTGGCCGAG
AAGCTCGTTGGAGTTTGCA->AGCTCGTTGGAGTTTGCAA
AAGGAATGGCCGGGGAGGG->AGGAATGGCCGGGGAGGGG
AAGGAGAGACTAGCGCGCT->AGGAGAGACTAGCGCGCTG
AAGGAGGTCCTTGGCCCCT->AGGAGGTCCTTGGCCCCTC
AAGGCTGGCCGAGCCCTTA->AGGCTGGCCGAGCCCTTAG
AAGGGAACTCTAGCTTGAT->AGGGAACTCTAGCTTGATC
AAGGGCCACTGTCCATCAT->AGGGCCACTGTCCATCATC
AAGGGGCGACCTGGCCCAG->AGGGGCGACCTGGCCCAGG
AAGGTTGCCGTAGTACTAA->AGGTTGCCGTAGTACTAAA
AAGGTTTGTGACTGATTCT->AGGTTTGTGACTGATTCTG
AAGTAACGGGGAAGGAGAG->AGTAACGGGGAAGGAGAGA
AAGTATGCGCCTCACAAGC->AGTATGCGCCTCACAAGCT
AAGTATTTCATTGCGGTGG->AGTATTTCATTGCGGTGGA
AAGTCCAAGGTTTGTGACT->AGTCCAAGGTTTGTGACTG
AAGTCCCCCTCCCATTTAG->AGTCCCCCTCCCATTTAGG
AAGTGCTCAATCACGACCG->AGTGCTCAATCACGACCGC
AAGTTTCACTACCGCTCAT->AGTTTCACTACCGCTCATA
AATAATGTATAAGAGACTA->ATAATGTATAAGAGACTAG
AATACTATCGCCCGAGGGG->ATACTATCGCCCGAGGGGC
AATAGCAGATAAGTATGCG->ATAGCAGATAAGTATGCGC
AATATGCGAAAAAGGGCCA->ATATGCGAAAAAGGGCCAC
AATCACGACCGCAGCTAAC->ATCACGACCGCAGCTAACC,ATCACGACCGCAGCTAACG,ATCACGACCGCAGCTAACC,ATCACGACCGCAGCTAACA
AATCAGGTGGTTCAGCAGC->ATCAGGTGGTTCAGCAGCG
AATCAGTGAGAAAATTTCC->ATCAGTGAGAAAATTTCCC
AATCATTCCACCGATAGCG->ATCATTCCACCGATAGCGT
AATCCGAACTAATGGCATA->ATCCGAACTAATGGCATAG
AATCGCAGTTAAGATGTAC->ATCGCAGTTAAGATGTACG
AATCTAAGCCTTAAGGCTG->ATCTAAGCCTTAAGGCTGG
AATCTCGGGAGTAGACGAC->ATCTCGGGAGTAGACGACT
AATCTCGTTCACAAAGTAT->ATCTCGTTCACAAAGTATT
AATCTGGACTGATTTAGCC->ATCTGGACTGATTTAGCCA
AATCTTAGGTGCAGCCATG->ATCTTAGGTGCAGCCATGG
AATGAGGGGGGACTTTGCC->ATGAGGGGGGACTTTGCCC
AATGCACGACATCGGCCGG->ATGCACGACATCGGCCGGA
AATGCATGAGATTACCGCG->ATGCATGAGATTACCGCGA
AATGCGAGGGAAAGTAACG->ATGCGAGGGAAAGTAACGG
AATGGCAGTAAGATAAGGG->ATGGCAGTAAGATAAGGGG
AATGGCATAGTCATGATGA->ATGGCATAGTCATGATGAT
AATGGCCGGGGAGGGGCCC->ATGGCCGGGGAGGGGCCCA
AATGGTCAATTAATCTCGG->ATGGTCAATTAATCTCGGG
AATGTATAAGAGACTAGGC->ATGTATAAGAGACTAGGCC
AATGTGGTATACACCCTAG->ATGTGGTATACACCCTAGT
AATGTTTGGTCATCTCGCA->ATGTTTGGTCATCTCGCAA
AATTAACTTCAGGTACTGT->ATTAACTTCAGGTACTGTT
AATTAATCTCGGGAGTAGA->ATTAATCTCGGGAGTAGAC
AATTACTGTCAACTGTATG->ATTACTGTCAACTGTATGC
AATTATAGAGCCTCGTCCA->ATTATAGAGCCTCGTCCAA
AATTATCAACACTGTATTC->ATTATCAACACTGTATTCT
AATTTAGTTGGTAACGTAT->ATTTAGTTGGTAACGTATC
AATTTCCCAGGGTCTTATA->ATTTCCCAGGGTCTTATAC
AATTTCGAGAGGCATGACA->ATTTCGAGAGGCATGACAA
ACAAAGCCAAGTTTCACTA->CAAAGCCAAGTTTCACTAC
ACAAAGTATTTCATTGCGG->CAAAGTATTTCATTGCGGT
ACAAATGGTCAATTAATCT->CAAATGGTCAATTAATCTC
ACAACCAATAATGTATAAG->CAACCAATAATGTATAAGA
ACAACTGGTAAAGCCCCCT->CAACTGGTAAAGCCCCCTG
ACAAGCTCGTTGGAGTTTG->CAAGCTCGTTGGAGTTTGC
ACAATATGCGAAAAAGGGC->CAATATGCGAAAAAGGGCC
ACACAAAGCCAAGTTTCAC->CACAAAGCCAAGTTTCACT
ACACACAAAGCCAAGTTTC->CACACAAAGCCAAGTTTCA
ACACCCTAGTGTATTTGAG->CACCCTAGTGTATTTGAGA
ACACCGGCACGTCGCCCTG->CACCGGCACGTCGCCCTGA
ACACGACAGCGGGCATCTC->CACGACAGCGGGCATCTCC
ACACGTTAAGGTTGCCGTA->CACGTTAAGGTTGCCGTAG
ACACTAAGACCGGAACGCT->CACTAAGACCGGAACGCTT
ACACTGTATTCTCGATGGT->CACTGTATTCTCGATGGTT
ACAGCCACGAGCATCCAAC->CAGCCACGAGCATCCAACC
ACAGCGGGCATCTCCAAGG->CAGCGGGCATCTCCAAGGA
ACAGCTGTTCTGCGATCGC->CAGCTGTTCTGCGATCGCG
ACAGGAATCACGACCGCAG->CAGGAATCACGACCGCAGC
ACAGTAGGAATGTTTGGTC->CAGTAGGAATGTTTGGTCA
ACAGTCAGCAAAACATAAT->CAGTCAGCAAAACATAATG
ACAGTGGATAGATGCGGAC->CAGTGGATAGATGCGGACA
ACAGTGTGACGAAAAAAAA->CAGTGTGACGAAAAAAAAT
ACATAACACGTTAAGGTTG->CATAACACGTTAAGGTTGC
ACATAATGTGGTATACACC->CATAATGTGGTATACACCC
ACATACGCCATATGGTCGC->CATACGCCATATGGTCGCG
ACATCGGCCGGATGTGAGT->CATCGGCCGGATGTGAGTC
ACATCTCCCAGCTATGACT->CATCTCCCAGCTATGACTA
ACATGGGTTTCCCGCTCCT->CATGGGTTTCCCGCTCCTG
ACATTGTCTGCGAGGTAGC->CATTGTCTGCGAGGTAGCA
ACATTTGTTGTTGGCATTT->CATTTGTTGTTGGCATTTA
ACCAAACAGTAGGAATGTT->CCAAACAGTAGGAATGTTT
ACCAAATCACGACCGCAGC->CCAAATCACGACCGCAGCT
ACCAATAATGTATAAGAGA->CCAATAATGTATAAGAGAC
ACCACAGTGTGACGAAAAA->CCACAGTGTGACGAAAAAA
ACCACCGTTATTTCCAGAC->CCACCGTTATTTCCAGACG
ACCAGCCTACCTCTGACGC->CCAGCCTACCTCTGACGCT
ACCCCGTCTCATCCTTGTC->CCCCGTCTCATCCTTGTCG
ACCCGGTTCGCAAACGGCA->CCCGGTTCGCAAACGGCAA
ACCCTAGTGTATTTGAGAA->CCCTAGTGTATTTGAGAAT
ACCCTTTTGGTCCTTATGA->CCCTTTTGGTCCTTATGAC
ACCGATAGCGTTGCTAGTG->CCGATAGCGTTGCTAGTGT
ACCGCAGCTAACATACGCC->CCGCAGCTAACATACGCCA
ACCGCAGCTAACCGCCCCA->CCGCAGCTAACCGCCCCAC
ACCGCAGCTAACCTCAGAG->CCGCAGCTAACCTCAGAGT
ACCGCAGCTAACGTCTCAG->CCGCAGCTAACGTCTCAGT
ACCGCCCCACTGGTGGCCA->CCGCCCCACTGGTGGCCAG
ACCGCGATGGTAACGCGGA->CCGCGATGGTAACGCGGAA
ACCGCTCATACATGGGTTT->CCGCTCATACATGGGTTTC
ACCGGAACGCTTATTGCCT->CCGGAACGCTTATTGCCTC
ACCGGCACGTCGCCCTGAC->CCGGCACGTCGCCCTGACA
ACCGTCATTCACACACAAA->CCGTCATTCACACACAAAG
ACCGTTATTTCCAGACGCA->CCGTTATTTCCAGACGCAG
ACCTATGGGTTTTGTGAAT->CCTATGGGTTTTGTGAATC
ACCTCAGAGTCGGTACCCC->CCTCAGAGTCGGTACCCCG
ACCTCTGACGCTTGGATGA->CCTCTGACGCTTGGATGAC
ACCTGACAGCTGTTCTGCG->CCTGACAGCTGTTCTGCGA
ACCTGGCCCAGGCCAGGAG->CCTGGCCCAGGCCAGGAGG
ACCTGTCGCTGCTCGAAAT->CCTGTCGCTGCTCGAAATT
ACCTTGAGTAATCAGGTGG->CCTTGAGTAATCAGGTGGT
ACGAAAAAAAATAGCAGAT->CGAAAAAAAATAGCAGATA
ACGAACCCTTTTGGTCCTT->CGAACCCTTTTGGTCCTTA
ACGACAGCGGGCATCTCCA->CGACAGCGGGCATCTCCAA
ACGACAGGAATCACGACCG->CGACAGGAATCACGACCGC
ACGACATCGGCCGGATGTG->CGACATCGGCCGGATGTGA
ACGACCGCAGCTAACATAC->CGACCGCAGCTAACATACG
ACGACCGCAGCTAACCGCC->CGACCGCAGCTAACCGCCC
ACGACCGCAGCTAACCTCA->CGACCGCAGCTAACCTCAG
ACGACCGCAGCTAACGTCT->CGACCGCAGCTAACGTCTC
ACGACTCGGTAGGAAAATG->CGACTCGGTAGGAAAATGC
ACGAGCATCCAACCACAGT->CGAGCATCCAACCACAGTG
ACGAGGCGAACTTTCCCAG->CGAGGCGAACTTTCCCAGG
ACGATTACAATATGCGAAA->CGATTACAATATGCGAAAA
ACGCAGATGAATGAGGGGG->CGCAGATGAATGAGGGGGG
ACGCCATATGGTCGCGAGT->CGCCATATGGTCGCGAGTA
ACGCCGCATAAGTCCCCCT->CGCCGCATAAGTCCCCCTC
ACGCGGAACTCGCGAACGA->CGCGGAACTCGCGAACGAT
ACGCTTATATGGAGAGATC->CGCTTATATGGAGAGATCT
ACGCTTATTGCCTCACCCG->CGCTTATTGCCTCACCCGG
ACGCTTGGATGACCTTGAG->CGCTTGGATGACCTTGAGT
ACGGAATCTGGACTGATTT->CGGAATCTGGACTGATTTA
ACGGCAACTCCCCTCTCTA->CGGCAACTCCCCTCTCTAT
ACGGGGAAGGAGAGACTAG->CGGGGAAGGAGAGACTAGC
ACGGGGCTACATCTCCCAG->CGGGGCTACATCTCCCAGC
ACGTATCGCCTGATACTAG->CGTATCGCCTGATACTAGA
ACGTCGATTGATTCACCTA->CGTCGATTGATTCACCTAT
ACGTCGCCCTGACACTAAG->CGTCGCCCTGACACTAAGA
ACGTCTCAGTAGAGTTTGC->CGTCTCAGTAGAGTTTGCT
ACGTTAAGGTTGCCGTAGT->CGTTAAGGTTGCCGTAGTA
ACGTTCTTACTCGCCATCG->CGTTCTTACTCGCCATCGA
ACTAAAAGTCCAAGGTTTG->CTAAAAGTCCAAGGTTTGT
ACTAAACTAAAAGTCCAAG->CTAAACTAAAAGTCCAAGG
ACTAAGACCGGAACGCTTA->CTAAGACCGGAACGCTTAT
ACTAATCTAAGCCTTAAGG->CTAATCTAAGCCTTAAGGC
ACTAATGGCATAGTCATGA->CTAATGGCATAGTCATGAT
ACTACCGCTCATACATGGG->CTACCGCTCATACATGGGT
ACTAGACTCAGTGCCGTCT->CTAGACTCAGTGCCGTCTT
ACTAGCGCGCTGATAACGA->CTAGCGCGCTGATAACGAC
ACTAGCGCGCTGCGCAAGT->CTAGCGCGCTGCGCAAGTG
ACTAGCGCGCTGGCCCCGC->CTAGCGCGCTGGCCCCGCA
ACTAGCGCGCTGTATGCGT->CTAGCGCGCTGTATGCGTG
ACTAGCGTCAGGCGGCACT->CTAGCGTCAGGCGGCACTA
ACTAGGCCATAGCTCCGGG->CTAGGCCATAGCTCCGGGG
ACTATCGCCCGAGGGGCGC->CTATCGCCCGAGGGGCGCG
ACTCAGTGCCGTCTTCTTG->CTCAGTGCCGTCTTCTTGG
ACTCCCCTCTCTATTTTAG->CTCCCCTCTCTATTTTAGA
ACTCGCAGTGGGCCCAGCG->CTCGCAGTGGGCCCAGCGG
ACTCGCCATCGAAGGAATG->CTCGCCATCGAAGGAATGG
ACTCGCGAACGATTACAAT->CTCGCGAACGATTACAATA
ACTCGGTAGGAAAATGCAT->CTCGGTAGGAAAATGCATG
ACTCTAGCTTGATCCAGGC->CTCTAGCTTGATCCAGGCC
ACTGATCCAATCTCGTTCA->CTGATCCAATCTCGTTCAC
ACTGATTCTGGTTAGGCGG->CTGATTCTGGTTAGGCGGA
ACTGATTTAGCCACCTGTC->CTGATTTAGCCACCTGTCG
ACTGGTAAAGCCCCCTGTT->CTGGTAAAGCCCCCTGTTG
ACTGGTCGCCGAGTATCAG->CTGGTCGCCGAGTATCAGG
ACTGGTGGCCAGTGGGGGA->CTGGTGGCCAGTGGGGGAC
ACTGTATGCTAAATTTAGT->CTGTATGCTAAATTTAGTT
ACTGTATTCTCGATGGTTC->CTGTATTCTCGATGGTTCG
ACTGTATTTAGGTGCTCCT->CTGTATTTAGGTGCTCCTG
ACTGTCAACTGTATGCTAA->CTGTCAACTGTATGCTAAA
ACTGTCCATCATCAAACAG->CTGTCCATCATCAAACAGT
ACTGTTCTGGCGTCCACTG->CTGTTCTGGCGTCCACTGG
ACTTCAGGTACTGTTCTGG->CTTCAGGTACTGTTCTGGC
ACTTCTCTGCACATAACAC->CTTCTCTGCACATAACACG
ACTTGACATTTGTTGTTGG->CTTGACATTTGTTGTTGGC
ACTTTCCCAGGGCTCCAGG->CTTTCCCAGGGCTCCAGGA
ACTTTGCCCGTCTGCTAAC->CTTTGCCCGTCTGCTAACG
AGAAAATTTCCCAGGGTCT->GAAAATTTCCCAGGGTCTT
AGAACCTGACAGCTGTTCT->GAACCTGACAGCTGTTCTG
AGAATCAGTGAGAAAATTT->GAATCAGTGAGAAAATTTC
AGACCGGAACGCTTATTGC->GACCGGAACGCTTATTGCC
AGACGACTCGGTAGGAAAA->GACGACTCGGTAGGAAAAT
AGACGCAGATGAATGAGGG->GACGCAGATGAATGAGGGG
AGACTAGCGCGCTGATAAC->GACTAGCGCGCTGATAACG
AGACTAGCGCGCTGCGCAA->GACTAGCGCGCTGCGCAAG
AGACTAGCGCGCTGGCCCC->GACTAGCGCGCTGGCCCCG
AGACTAGCGCGCTGTATGC->GACTAGCGCGCTGTATGCG
AGACTAGGCCATAGCTCCG->GACTAGGCCATAGCTCCGG
AGACTCAGTGCCGTCTTCT->GACTCAGTGCCGTCTTCTT
AGAGACTAGCGCGCTGATA->GAGACTAGCGCGCTGATAA
AGAGACTAGCGCGCTGCGC->GAGACTAGCGCGCTGCGCA
AGAGACTAGCGCGCTGGCC->GAGACTAGCGCGCTGGCCC
AGAGACTAGCGCGCTGTAT->GAGACTAGCGCGCTGTATG
AGAGACTAGGCCATAGCTC->GAGACTAGGCCATAGCTCC
AGAGATCTGTCCGAATTAA->GAGATCTGTCCGAATTAAC
AGAGCCAGTCCACTGATCC->GAGCCAGTCCACTGATCCA
AGAGCCTCGTCCAAAATTT->GAGCCTCGTCCAAAATTTC
AGAGGCATGACAAATGGTC->GAGGCATGACAAATGGTCA
AGAGGCTCTCATTAATTAT->GAGGCTCTCATTAATTATC
AGAGGGAGGGCTGTCGTTA->GAGGGAGGGCTGTCGTTAT
AGAGTCGGTACCCCGTCTC->GAGTCGGTACCCCGTCTCA
AGAGTTTGCTAGGCGCGTA->GAGTTTGCTAGGCGCGTAG
AGATAAGGGGCGACCTGGC->GATAAGGGGCGACCTGGCC
AGATAAGTATGCGCCTCAC->GATAAGTATGCGCCTCACA
AGATCAGCTGGGCTTGAGC->GATCAGCTGGGCTTGAGCA
AGATCTGTCCGAATTAACT->GATCTGTCCGAATTAACTT
AGATGAATGAGGGGGGACT->GATGAATGAGGGGGGACTT
AGATGCGGACACCGGCACG->GATGCGGACACCGGCACGT
AGATGGTTCAAATGCGAGG->GATGGTTCAAATGCGAGGG
AGATGTACGTTCTTACTCG->GATGTACGTTCTTACTCGC
AGATTACCGCGATGGTAAC->GATTACCGCGATGGTAACG
AGCAAAACATAATGTGGTA->GCAAAACATAATGTGGTAT
AGCAAGCACCACCGTTATT->GCAAGCACCACCGTTATTT
AGCACCACCGTTATTTCCA->GCACCACCGTTATTTCCAG
AGCACGTCGATTGATTCAC->GCACGTCGATTGATTCACC
AGCACTTCTCTGCACATAA->GCACTTCTCTGCACATAAC
AGCAGATAAGTATGCGCCT->GCAGATAAGTATGCGCCTC
AGCAGCAAGCACCACCGTT->GCAGCAAGCACCACCGTTA
AGCAGCGCTGGTGGAGAGA->GCAGCGCTGGTGGAGAGAC
AGCATCCAACCACAGTGTG->GCATCCAACCACAGTGTGA
AGCATTCAGCAGCAAGCAC->GCATTCAGCAGCAAGCACC
AGCCAAGTTTCACTACCGC->GCCAAGTTTCACTACCGCT
AGCCACCTGTCGCTGCTCG->GCCACCTGTCGCTGCTCGA
AGCCACGAGCATCCAACCA->GCCACGAGCATCCAACCAC
AGCCAGTCCACTGATCCAA->GCCAGTCCACTGATCCAAT
AGCCATGGAATGGCAGTAA->GCCATGGAATGGCAGTAAG
AGCCCCCCCGCCCCTACCA->GCCCCCCCGCCCCTACCAA
AGCCCCCTGTTGAGAACCT->GCCCCCTGTTGAGAACCTG
AGCCCTTAGATCAGCTGGG->GCCCTTAGATCAGCTGGGC
AGCCTAAATACTATCGCCC->GCCTAAATACTATCGCCCG
AGCCTACCTCTGACGCTTG->GCCTACCTCTGACGCTTGG
AGCCTCGTCCAAAATTTCG->GCCTCGTCCAAAATTTCGA
AGCCTTAAGGCTGGCCGAG->GCCTTAAGGCTGGCCGAGC
AGCGAAGAGGCTCTCATTA->GCGAAGAGGCTCTCATTAA
AGCGCGCTGATAACGACAG->GCGCGCTGATAACGACAGG
AGCGCGCTGCGCAAGTGCT->GCGCGCTGCGCAAGTGCTC
AGCGCGCTGGCCCCGCACC->GCGCGCTGGCCCCGCACCA
AGCGCGCTGTATGCGTGGG->GCGCGCTGTATGCGTGGGT
AGCGCTGGTGGAGAGACTA->GCGCTGGTGGAGAGACTAG
AGCGGGCATCTCCAAGGAG->GCGGGCATCTCCAAGGAGG
AGCGGTAGCCTAAATACTA->GCGGTAGCCTAAATACTAT
AGCGTCAGGCGGCACTAGC->GCGTCAGGCGGCACTAGCA
AGCGTTGCTAGTGTCAACA->GCGTTGCTAGTGTCAACAG
AGCTAACATACGCCATATG->GCTAACATACGCCATATGG
AGCTAACCGCCCCACTGGT->GCTAACCGCCCCACTGGTG
AGCTAACCTCAGAGTCGGT->GCTAACCTCAGAGTCGGTA
AGCTAACGTCTCAGTAGAG->GCTAACGTCTCAGTAGAGT
AGCTATGACTAATCTAAGC->GCTATGACTAATCTAAGCC
AGCTCCGGGGGCCACGCTT->GCTCCGGGGGCCACGCTTA
AGCTCGTTGGAGTTTGCAA->GCTCGTTGGAGTTTGCAAC
AGCTGGGCTTGAGCACTTC->GCTGGGCTTGAGCACTTCT
AGCTGTTCTGCGATCGCGA->GCTGTTCTGCGATCGCGAT
AGCTTGATCCAGGCCATCC->GCTTGATCCAGGCCATCCG
AGGAAAATGCATGAGATTA->GGAAAATGCATGAGATTAC
AGGAAGAGCCAGTCCACTG->GGAAGAGCCAGTCCACTGA
AGGAATCACGACCGCAGCT->GGAATCACGACCGCAGCTA
AGGAATGGCCGGGGAGGGG->GGAATGGCCGGGGAGGGGC
AGGAATGTTTGGTCATCTC->GGAATGTTTGGTCATCTCG
AGGAGAGACTAGCGCGCTG->GGAGAGACTAGCGCGCTGA
AGGAGGCCTATAGGGAGAG->GGAGGCCTATAGGGAGAGA
AGGAGGTCCTTGGCCCCTC->GGAGGTCCTTGGCCCCTCC
AGGATGAACGAACCCTTTT->GGATGAACGAACCCTTTTG
AGGCATGACAAATGGTCAA->GGCATGACAAATGGTCAAT
AGGCCAGGAGGCCTATAGG->GGCCAGGAGGCCTATAGGG
AGGCCATAGCTCCGGGGGC->GGCCATAGCTCCGGGGGCC
AGGCCATCCGAATGCACGA->GGCCATCCGAATGCACGAC
AGGCCTATAGGGAGAGACT->GGCCTATAGGGAGAGACTA
AGGCGAACTTTCCCAGGGC->GGCGAACTTTCCCAGGGCT
AGGCGCGTAGGGGACGAGG->GGCGCGTAGGGGACGAGGC
AGGCGGAGAGACTAGCGCG->GGCGGAGAGACTAGCGCGC
AGGCTCTCATTAATTATCA->GGCTCTCATTAATTATCAA
AGGCTGGCCGAGCCCTTAG->GGCTGGCCGAGCCCTTAGA
AGGGAAAGTAACGGGGAAG->GGGAAAGTAACGGGGAAGG
AGGGAACAACCAATAATGT->GGGAACAACCAATAATGTA
AGGGAACTCTAGCTTGATC->GGGAACTCTAGCTTGATCC
AGGGAGAGACTAGCGCGCT->GGGAGAGACTAGCGCGCTG
AGGGAGGGCTGTCGTTATT->GGGAGGGCTGTCGTTATTC
AGGGCCACTGTCCATCATC->GGGCCACTGTCCATCATCA
AGGGCGCCAACAACTGGTA->GGGCGCCAACAACTGGTAA
AGGGCTCCAGGAAGAGCCA->GGGCTCCAGGAAGAGCCAG
AGGGCTGTCGTTATTCTGT->GGGCTGTCGTTATTCTGTC
AGGGGACGAGGCGAACTTT->GGGGACGAGGCGAACTTTC
AGGGGCCCATCCTAATCTT->GGGGCCCATCCTAATCTTA
AGGGGCGACCTGGCCCAGG->GGGGCGACCTGGCCCAGGC
AGGGGCGCGTGCGATAAAA->GGGGCGCGTGCGATAAAAG
AGGGGGGACTTTGCCCGTC->GGGGGGACTTTGCCCGTCT
AGGGTCTTATACATTGTCT->GGGTCTTATACATTGTCTG
AGGTACTGTTCTGGCGTCC->GGTACTGTTCTGGCGTCCA
AGGTAGCATTCAGCAGCAA->GGTAGCATTCAGCAGCAAG
AGGTCCTCACGCCGCATAA->GGTCCTCACGCCGCATAAG
AGGTCCTTGGCCCCTCCAT->GGTCCTTGGCCCCTCCATG
AGGTGCAGCCATGGAATGG->GGTGCAGCCATGGAATGGC
AGGTGCTCCTGGTCCGAAA->GGTGCTCCTGGTCCGAAAC
AGGTGGTTCAGCAGCGCTG->GGTGGTTCAGCAGCGCTGG
AGGTTGCCGTAGTACTAAA->GGTTGCCGTAGTACTAAAC
AGGTTTGTGACTGATTCTG->GGTTTGTGACTGATTCTGG
AGGTTTTATAAATCATTCC->GGTTTTATAAATCATTCCA
AGTAACGGGGAAGGAGAGA->GTAACGGGGAAGGAGAGAC
AGTAAGATAAGGGGCGACC->GTAAGATAAGGGGCGACCT
AGTAATCAGGTGGTTCAGC->GTAATCAGGTGGTTCAGCA
AGTACTAAACTAAAAGTCC->GTACTAAACTAAAAGTCCA
AGTACTTGACATTTGTTGT->GTACTTGACATTTGTTGTT
AGTAGACGACTCGGTAGGA->GTAGACGACTCGGTAGGAA
AGTAGAGTTTGCTAGGCGC->GTAGAGTTTGCTAGGCGCG
AGTAGGAATGTTTGGTCAT->GTAGGAATGTTTGGTCATC
AGTATCAGGTCCTCACGCC->GTATCAGGTCCTCACGCCG
AGTATGCGCCTCACAAGCT->GTATGCGCCTCACAAGCTC
AGTATTTCATTGCGGTGGA->GTATTTCATTGCGGTGGAA
AGTCAGCAAAACATAATGT->GTCAGCAAAACATAATGTG
AGTCATGATGATAGGGAAC->GTCATGATGATAGGGAACA
AGTCCAAGGTTTGTGACTG->GTCCAAGGTTTGTGACTGA
AGTCCACTGATCCAATCTC->GTCCACTGATCCAATCTCG
AGTCCAGGGCGCCAACAAC->GTCCAGGGCGCCAACAACT
AGTCCCCCTCCCATTTAGG->GTCCCCCTCCCATTTAGGT
AGTCGGTACCCCGTCTCAT->GTCGGTACCCCGTCTCATC
AGTGAGAAAATTTCCCAGG->GTGAGAAAATTTCCCAGGG
AGTGCCGTCTTCTTGGAGA->GTGCCGTCTTCTTGGAGAT
AGTGCTCAATCACGACCGC->GTGCTCAATCACGACCGCA
AGTGGATAGATGCGGACAC->GTGGATAGATGCGGACACC
AGTGGGCCCAGCGGTAGCC->GTGGGCCCAGCGGTAGCCT
AGTGGGGGACTCGCAGTGG->GTGGGGGACTCGCAGTGGG
AGTGTATTTGAGAATCAGT->GTGTATTTGAGAATCAGTG
AGTGTCAACAGTCAGCAAA->GTGTCAACAGTCAGCAAAA
AGTGTGACGAAAAAAAATA->GTGTGACGAAAAAAAATAG
AGTTAAGATGTACGTTCTT->GTTAAGATGTACGTTCTTA
AGTTGGTAACGTATCGCCT->GTTGGTAACGTATCGCCTG
AGTTTCACTACCGCTCATA->GTTTCACTACCGCTCATAC
AGTTTGCAACTAGCGTCAG->GTTTGCAACTAGCGTCAGG
AGTTTGCTAGGCGCGTAGG->GTTTGCTAGGCGCGTAGGG
ATAAAAGGGAACTCTAGCT->TAAAAGGGAACTCTAGCTT
ATAAATCATTCCACCGATA->TAAATCATTCCACCGATAG
ATAACACGTTAAGGTTGCC->TAACACGTTAAGGTTGCCG
ATAACGACAGGAATCACGA->TAACGACAGGAATCACGAC
ATAAGAGACTAGGCCATAG->TAAGAGACTAGGCCATAGC
ATAAGGGGCGACCTGGCCC->TAAGGGGCGACCTGGCCCA
ATAAGTATGCGCCTCACAA->TAAGTATGCGCCTCACAAG
ATAAGTCCCCCTCCCATTT->TAAGTCCCCCTCCCATTTA
ATAATGTATAAGAGACTAG->TAATGTATAAGAGACTAGG
ATAATGTGGTATACACCCT->TAATGTGGTATACACCCTA
ATACACCCTAGTGTATTTG->TACACCCTAGTGTATTTGA
ATACATGGGTTTCCCGCTC->TACATGGGTTTCCCGCTCC
ATACATTGTCTGCGAGGTA->TACATTGTCTGCGAGGTAG
ATACGCCATATGGTCGCGA->TACGCCATATGGTCGCGAG
ATACTAGACTCAGTGCCGT->TACTAGACTCAGTGCCGTC
ATACTATCGCCCGAGGGGC->TACTATCGCCCGAGGGGCG
ATAGAGCCTCGTCCAAAAT->TAGAGCCTCGTCCAAAATT
ATAGATGCGGACACCGGCA->TAGATGCGGACACCGGCAC
ATAGCAGATAAGTATGCGC->TAGCAGATAAGTATGCGCC
ATAGCGTTGCTAGTGTCAA->TAGCGTTGCTAGTGTCAAC
ATAGCTCCGGGGGCCACGC->TAGCTCCGGGGGCCACGCT
ATAGGGAACAACCAATAAT->TAGGGAACAACCAATAATG
ATAGGGAGAGACTAGCGCG->TAGGGAGAGACTAGCGCGC
ATAGTCATGATGATAGGGA->TAGTCATGATGATAGGGAA
ATATGCGAAAAAGGGCCAC->TATGCGAAAAAGGGCCACT
ATATGGAGAGATCTGTCCG->TATGGAGAGATCTGTCCGA
ATATGGTCGCGAGTACTTG->TATGGTCGCGAGTACTTGA
ATCAAACAGTGGATAGATG->TCAAACAGTGGATAGATGC
ATCAACACTGTATTCTCGA->TCAACACTGTATTCTCGAT
ATCACGACCGCAGCTAACA->TCACGACCGCAGCTAACAT
ATCACGACCGCAGCTAACC->TCACGACCGCAGCTAACCG,TCACGACCGCAGCTAACCT
ATCACGACCGCAGCTAACG->TCACGACCGCAGCTAACGT
ATCAGCTGGGCTTGAGCAC->TCAGCTGGGCTTGAGCACT
ATCAGGTCCTCACGCCGCA->TCAGGTCCTCACGCCGCAT
ATCAGGTGGTTCAGCAGCG->TCAGGTGGTTCAGCAGCGC
ATCAGTGAGAAAATTTCCC->TCAGTGAGAAAATTTCCCA
ATCATCAAACAGTGGATAG->TCATCAAACAGTGGATAGA
ATCATTCCACCGATAGCGT->TCATTCCACCGATAGCGTT
ATCCAACCACAGTGTGACG->TCCAACCACAGTGTGACGA
ATCCAATCTCGTTCACAAA->TCCAATCTCGTTCACAAAG
ATCCACAGCCACGAGCATC->TCCACAGCCACGAGCATCC
ATCCAGGCCATCCGAATGC->TCCAGGCCATCCGAATGCA
ATCCGAACTAATGGCATAG->TCCGAACTAATGGCATAGT
ATCCGAATGCACGACATCG->TCCGAATGCACGACATCGG
ATCCTAATCTTAGGTGCAG->TCCTAATCTTAGGTGCAGC
ATCCTTGTCGTCTTTTGCG->TCCTTGTCGTCTTTTGCGC
ATCGAAGGAATGGCCGGGG->TCGAAGGAATGGCCGGGGA
ATCGCAGTTAAGATGTACG->TCGCAGTTAAGATGTACGT
ATCGCCCGAGGGGCGCGTG->TCGCCCGAGGGGCGCGTGC
ATCGCCTGATACTAGACTC->TCGCCTGATACTAGACTCA
ATCGCGATGCGCTCCCCGT->TCGCGATGCGCTCCCCGTA
ATCGGCCGGATGTGAGTCC->TCGGCCGGATGTGAGTCCA
ATCTAAGCCTTAAGGCTGG->TCTAAGCCTTAAGGCTGGC
ATCTCCAAGGAGGTCCTTG->TCTCCAAGGAGGTCCTTGG
ATCTCCCAGCTATGACTAA->TCTCCCAGCTATGACTAAT
ATCTCGCAACTGTATTTAG->TCTCGCAACTGTATTTAGG
ATCTCGGGAGTAGACGACT->TCTCGGGAGTAGACGACTC
ATCTCGTTCACAAAGTATT->TCTCGTTCACAAAGTATTT
ATCTGGACTGATTTAGCCA->TCTGGACTGATTTAGCCAC
ATCTGTCCGAATTAACTTC->TCTGTCCGAATTAACTTCA
ATCTTAGGTGCAGCCATGG->TCTTAGGTGCAGCCATGGA
ATGAACGAACCCTTTTGGT->TGAACGAACCCTTTTGGTC
ATGAATGAGGGGGGACTTT->TGAATGAGGGGGGACTTTG
ATGACAAATGGTCAATTAA->TGACAAATGGTCAATTAAT
ATGACCAGCCTACCTCTGA->TGACCAGCCTACCTCTGAC
ATGACCTTGAGTAATCAGG->TGACCTTGAGTAATCAGGT
ATGACTAATCTAAGCCTTA->TGACTAATCTAAGCCTTAA
ATGAGATTACCGCGATGGT->TGAGATTACCGCGATGGTA
ATGAGGGGGGACTTTGCCC->TGAGGGGGGACTTTGCCCG
ATGATAGGGAACAACCAAT->TGATAGGGAACAACCAATA
ATGATGATAGGGAACAACC->TGATGATAGGGAACAACCA
ATGCAAATTATAGAGCCTC->TGCAAATTATAGAGCCTCG
ATGCACGACATCGGCCGGA->TGCACGACATCGGCCGGAT
ATGCATGAGATTACCGCGA->TGCATGAGATTACCGCGAT
ATGCGAAAAAGGGCCACTG->TGCGAAAAAGGGCCACTGT
ATGCGAGGGAAAGTAACGG->TGCGAGGGAAAGTAACGGG
ATGCGCCTCACAAGCTCGT->TGCGCCTCACAAGCTCGTT
ATGCGCTCCCCGTATCCAC->TGCGCTCCCCGTATCCACA
ATGCGGACACCGGCACGTC->TGCGGACACCGGCACGTCG
ATGCGTGGGTAATCACGAC->TGCGTGGGTAATCACGACC
ATGCTAAATTTAGTTGGTA->TGCTAAATTTAGTTGGTAA
ATGGAATGGCAGTAAGATA->TGGAATGGCAGTAAGATAA
ATGGAGAGATCTGTCCGAA->TGGAGAGATCTGTCCGAAT
ATGGCAGTAAGATAAGGGG->TGGCAGTAAGATAAGGGGC
ATGGCATAGTCATGATGAT->TGGCATAGTCATGATGATA
ATGGCCGGGGAGGGGCCCA->TGGCCGGGGAGGGGCCCAT
ATGGGTTTCCCGCTCCTGG->TGGGTTTCCCGCTCCTGGG
ATGGGTTTTGTGAATCGCA->TGGGTTTTGTGAATCGCAG
ATGGTAACGCGGAACTCGC->TGGTAACGCGGAACTCGCG
ATGGTCAATTAATCTCGGG->TGGTCAATTAATCTCGGGA
ATGGTCGCGAGTACTTGAC->TGGTCGCGAGTACTTGACA
ATGGTTCAAATGCGAGGGA->TGGTTCAAATGCGAGGGAA
ATGGTTCGGCAGGATGAAC->TGGTTCGGCAGGATGAACG
ATGTACGTTCTTACTCGCC->TGTACGTTCTTACTCGCCA
ATGTATAAGAGACTAGGCC->TGTATAAGAGACTAGGCCA
ATGTGAGTCCAGGGCGCCA->TGTGAGTCCAGGGCGCCAA
ATGTGGTATACACCCTAGT->TGTGGTATACACCCTAGTG
ATGTTTGGTCATCTCGCAA->TGTTTGGTCATCTCGCAAC
ATTAACTTCAGGTACTGTT->TTAACTTCAGGTACTGTTC
ATTAATCTCGGGAGTAGAC->TTAATCTCGGGAGTAGACG
ATTAATTATCAACACTGTA->TTAATTATCAACACTGTAT
ATTACAATATGCGAAAAAG->TTACAATATGCGAAAAAGG
ATTACCGCGATGGTAACGC->TTACCGCGATGGTAACGCG
ATTACTGTCAACTGTATGC->TTACTGTCAACTGTATGCT
ATTATAGAGCCTCGTCCAA->TTATAGAGCCTCGTCCAAA
ATTATCAACACTGTATTCT->TTATCAACACTGTATTCTC
ATTCACACACAAAGCCAAG->TTCACACACAAAGCCAAGT
ATTCACCTATGGGTTTTGT->TTCACCTATGGGTTTTGTG
ATTCAGCAGCAAGCACCAC->TTCAGCAGCAAGCACCACC
ATTCCACCGATAGCGTTGC->TTCCACCGATAGCGTTGCT
ATTCTCGATGGTTCGGCAG->TTCTCGATGGTTCGGCAGG
ATTCTGGTTAGGCGGAGAG->TTCTGGTTAGGCGGAGAGA
ATTCTGTCAGCACGTCGAT->TTCTGTCAGCACGTCGATT
ATTGATTCACCTATGGGTT->TTGATTCACCTATGGGTTT
ATTGCCTCACCCGGTTCGC->TTGCCTCACCCGGTTCGCA
ATTGCGGTGGAACACGACA->TTGCGGTGGAACACGACAG
ATTGTCTGCGAGGTAGCAT->TTGTCTGCGAGGTAGCATT
ATTTAGCCACCTGTCGCTG->TTTAGCCACCTGTCGCTGC
ATTTAGCCCCCCCGCCCCT->TTTAGCCCCCCCGCCCCTA
ATTTAGGTGCTCCTGGTCC->TTTAGGTGCTCCTGGTCCG
ATTTAGGTTTTATAAATCA->TTTAGGTTTTATAAATCAT
ATTTAGTTGGTAACGTATC->TTTAGTTGGTAACGTATCG
ATTTCATTGCGGTGGAACA->TTTCATTGCGGTGGAACAC
ATTTCCAGACGCAGATGAA->TTTCCAGACGCAGATGAAT
ATTTCCCAGGGTCTTATAC->TTTCCCAGGGTCTTATACA
ATTTCGAGAGGCATGACAA->TTTCGAGAGGCATGACAAA
ATTTGAGAATCAGTGAGAA->TTTGAGAATCAGTGAGAAA
ATTTGTTGTTGGCATTTAG->TTTGTTGTTGGCATTTAGC
ATTTTAGAGGGAGGGCTGT->TTTTAGAGGGAGGGCTGTC
CAAAACATAATGTGGTATA->AAAACATAATGTGGTATAC
CAAAATTTCGAGAGGCATG->AAAATTTCGAGAGGCATGA
CAAACAGTAGGAATGTTTG->AAACAGTAGGAATGTTTGG
CAAACAGTGGATAGATGCG->AAACAGTGGATAGATGCGG
CAAACGGCAACTCCCCTCT->AAACGGCAACTCCCCTCTC
CAAAGCCAAGTTTCACTAC->AAAGCCAAGTTTCACTACC
CAAAGTATTTCATTGCGGT->AAAGTATTTCATTGCGGTG
CAAATCACGACCGCAGCTA->AAATCACGACCGCAGCTAA
CAAATGCGAGGGAAAGTAA->AAATGCGAGGGAAAGTAAC
CAAATGGTCAATTAATCTC->AAATGGTCAATTAATCTCG
CAAATTATAGAGCCTCGTC->AAATTATAGAGCCTCGTCC
CAACAACTGGTAAAGCCCC->AACAACTGGTAAAGCCCCC
CAACACTGTATTCTCGATG->AACACTGTATTCTCGATGG
CAACAGTCAGCAAAACATA->AACAGTCAGCAAAACATAA
CAACCAATAATGTATAAGA->AACCAATAATGTATAAGAG
CAACCACAGTGTGACGAAA->AACCACAGTGTGACGAAAA
CAACTAGCGTCAGGCGGCA->AACTAGCGTCAGGCGGCAC
CAACTCCCCTCTCTATTTT->AACTCCCCTCTCTATTTTA
CAACTGGTAAAGCCCCCTG->AACTGGTAAAGCCCCCTGT
CAACTGTATGCTAAATTTA->AACTGTATGCTAAATTTAG
CAACTGTATTTAGGTGCTC->AACTGTATTTAGGTGCTCC
CAAGCACCACCGTTATTTC->AAGCACCACCGTTATTTCC
CAAGCTCGTTGGAGTTTGC->AAGCTCGTTGGAGTTTGCA
CAAGGAGGTCCTTGGCCCC->AAGGAGGTCCTTGGCCCCT
CAAGGTTTGTGACTGATTC->AAGGTTTGTGACTGATTCT
CAAGTGCTCAATCACGACC->AAGTGCTCAATCACGACCG
CAAGTTTCACTACCGCTCA->AAGTTTCACTACCGCTCAT
CAATAATGTATAAGAGACT->AATAATGTATAAGAGACTA
CAATATGCGAAAAAGGGCC->AATATGCGAAAAAGGGCCA
CAATCACGACCGCAGCTAA->AATCACGACCGCAGCTAAC
CAATCCGAACTAATGGCAT->AATCCGAACTAATGGCATA
CAATCTCGTTCACAAAGTA->AATCTCGTTCACAAAGTAT
CAATTAATCTCGGGAGTAG->AATTAATCTCGGGAGTAGA
CACAAAGCCAAGTTTCACT->ACAAAGCCAAGTTTCACTA
CACAAAGTATTTCATTGCG->ACAAAGTATTTCATTGCGG
CACAAGCTCGTTGGAGTTT->ACAAGCTCGTTGGAGTTTG
CACACAAAGCCAAGTTTCA->ACACAAAGCCAAGTTTCAC
CACACACAAAGCCAAGTTT->ACACACAAAGCCAAGTTTC
CACAGCCACGAGCATCCAA->ACAGCCACGAGCATCCAAC
CACAGTGTGACGAAAAAAA->ACAGTGTGACGAAAAAAAA
CACATAACACGTTAAGGTT->ACATAACACGTTAAGGTTG
CACCAAATCACGACCGCAG->ACCAAATCACGACCGCAGC
CACCACCGTTATTTCCAGA->ACCACCGTTATTTCCAGAC
CACCCGGTTCGCAAACGGC->ACCCGGTTCGCAAACGGCA
CACCCTAGTGTATTTGAGA->ACCCTAGTGTATTTGAGAA
CACCGATAGCGTTGCTAGT->ACCGATAGCGTTGCTAGTG
CACCGGCACGTCGCCCTGA->ACCGGCACGTCGCCCTGAC
CACCGTTATTTCCAGACGC->ACCGTTATTTCCAGACGCA
CACCTATGGGTTTTGTGAA->ACCTATGGGTTTTGTGAAT
CACCTGTCGCTGCTCGAAA->ACCTGTCGCTGCTCGAAAT
CACGACAGCGGGCATCTCC->ACGACAGCGGGCATCTCCA
CACGACATCGGCCGGATGT->ACGACATCGGCCGGATGTG
CACGACCGCAGCTAACATA->ACGACCGCAGCTAACATAC
CACGACCGCAGCTAACCGC->ACGACCGCAGCTAACCGCC
CACGACCGCAGCTAACCTC->ACGACCGCAGCTAACCTCA
CACGACCGCAGCTAACGTC->ACGACCGCAGCTAACGTCT
CACGAGCATCCAACCACAG->ACGAGCATCCAACCACAGT
CACGCCGCATAAGTCCCCC->ACGCCGCATAAGTCCCCCT
CACGCTTATATGGAGAGAT->ACGCTTATATGGAGAGATC
CACGTCGATTGATTCACCT->ACGTCGATTGATTCACCTA
CACGTCGCCCTGACACTAA->ACGTCGCCCTGACACTAAG
CACGTTAAGGTTGCCGTAG->ACGTTAAGGTTGCCGTAGT
CACTAAGACCGGAACGCTT->ACTAAGACCGGAACGCTTA
CACTACCGCTCATACATGG->ACTACCGCTCATACATGGG
CACTGATCCAATCTCGTTC->ACTGATCCAATCTCGTTCA
CACTGGTCGCCGAGTATCA->ACTGGTCGCCGAGTATCAG
CACTGGTGGCCAGTGGGGG->ACTGGTGGCCAGTGGGGGA
CACTGTATTCTCGATGGTT->ACTGTATTCTCGATGGTTC
CACTGTCCATCATCAAACA->ACTGTCCATCATCAAACAG
CACTTCTCTGCACATAACA->ACTTCTCTGCACATAACAC
CAGACGCAGATGAATGAGG->AGACGCAGATGAATGAGGG
CAGAGTCGGTACCCCGTCT->AGAGTCGGTACCCCGTCTC
CAGATAAGTATGCGCCTCA->AGATAAGTATGCGCCTCAC
CAGATGAATGAGGGGGGAC->AGATGAATGAGGGGGGACT
CAGCAAAACATAATGTGGT->AGCAAAACATAATGTGGTA
CAGCAAGCACCACCGTTAT->AGCAAGCACCACCGTTATT
CAGCACGTCGATTGATTCA->AGCACGTCGATTGATTCAC
CAGCAGCAAGCACCACCGT->AGCAGCAAGCACCACCGTT
CAGCAGCGCTGGTGGAGAG->AGCAGCGCTGGTGGAGAGA
CAGCCACGAGCATCCAACC->AGCCACGAGCATCCAACCA
CAGCCATGGAATGGCAGTA->AGCCATGGAATGGCAGTAA
CAGCCTACCTCTGACGCTT->AGCCTACCTCTGACGCTTG
CAGCGCTGGTGGAGAGACT->AGCGCTGGTGGAGAGACTA
CAGCGGGCATCTCCAAGGA->AGCGGGCATCTCCAAGGAG
CAGCGGTAGCCTAAATACT->AGCGGTAGCCTAAATACTA
CAGCTAACATACGCCATAT->AGCTAACATACGCCATATG
CAGCTAACCGCCCCACTGG->AGCTAACCGCCCCACTGGT
CAGCTAACCTCAGAGTCGG->AGCTAACCTCAGAGTCGGT
CAGCTAACGTCTCAGTAGA->AGCTAACGTCTCAGTAGAG
CAGCTATGACTAATCTAAG->AGCTATGACTAATCTAAGC
CAGCTGGGCTTGAGCACTT->AGCTGGGCTTGAGCACTTC
CAGCTGTTCTGCGATCGCG->AGCTGTTCTGCGATCGCGA
CAGGAAGAGCCAGTCCACT->AGGAAGAGCCAGTCCACTG
CAGGAATCACGACCGCAGC->AGGAATCACGACCGCAGCT
CAGGAGGCCTATAGGGAGA->AGGAGGCCTATAGGGAGAG
CAGGATGAACGAACCCTTT->AGGATGAACGAACCCTTTT
CAGGCCAGGAGGCCTATAG->AGGCCAGGAGGCCTATAGG
CAGGCCATCCGAATGCACG->AGGCCATCCGAATGCACGA
CAGGGCGCCAACAACTGGT->AGGGCGCCAACAACTGGTA
CAGGGCTCCAGGAAGAGCC->AGGGCTCCAGGAAGAGCCA
CAGGGTCTTATACATTGTC->AGGGTCTTATACATTGTCT
CAGGTACTGTTCTGGCGTC->AGGTACTGTTCTGGCGTCC
CAGGTCCTCACGCCGCATA->AGGTCCTCACGCCGCATAA
CAGGTGGTTCAGCAGCGCT->AGGTGGTTCAGCAGCGCTG
CAGTAAGATAAGGGGCGAC->AGTAAGATAAGGGGCGACC
CAGTAGAGTTTGCTAGGCG->AGTAGAGTTTGCTAGGCGC
CAGTAGGAATGTTTGGTCA->AGTAGGAATGTTTGGTCAT
CAGTCAGCAAAACATAATG->AGTCAGCAAAACATAATGT
CAGTCCACTGATCCAATCT->AGTCCACTGATCCAATCTC
CAGTGAGAAAATTTCCCAG->AGTGAGAAAATTTCCCAGG
CAGTGCCGTCTTCTTGGAG->AGTGCCGTCTTCTTGGAGA
CAGTGGATAGATGCGGACA->AGTGGATAGATGCGGACAC
CAGTGGGCCCAGCGGTAGC->AGTGGGCCCAGCGGTAGCC
CAGTGGGGGACTCGCAGTG->AGTGGGGGACTCGCAGTGG
CAGTGTGACGAAAAAAAAT->AGTGTGACGAAAAAAAATA
CAGTTAAGATGTACGTTCT->AGTTAAGATGTACGTTCTT
CATAACACGTTAAGGTTGC->ATAACACGTTAAGGTTGCC
CATAAGTCCCCCTCCCATT->ATAAGTCCCCCTCCCATTT
CATAATGTGGTATACACCC->ATAATGTGGTATACACCCT
CATACATGGGTTTCCCGCT->ATACATGGGTTTCCCGCTC
CATACGCCATATGGTCGCG->ATACGCCATATGGTCGCGA
CATAGCTCCGGGGGCCACG->ATAGCTCCGGGGGCCACGC
CATAGTCATGATGATAGGG->ATAGTCATGATGATAGGGA
CATATGGTCGCGAGTACTT->ATATGGTCGCGAGTACTTG
CATCAAACAGTGGATAGAT->ATCAAACAGTGGATAGATG
CATCATCAAACAGTGGATA->ATCATCAAACAGTGGATAG
CATCCAACCACAGTGTGAC->ATCCAACCACAGTGTGACG
CATCCGAATGCACGACATC->ATCCGAATGCACGACATCG
CATCCTAATCTTAGGTGCA->ATCCTAATCTTAGGTGCAG
CATCCTTGTCGTCTTTTGC->ATCCTTGTCGTCTTTTGCG
CATCGAAGGAATGGCCGGG->ATCGAAGGAATGGCCGGGG
CATCGGCCGGATGTGAGTC->ATCGGCCGGATGTGAGTCC
CATCTCCAAGGAGGTCCTT->ATCTCCAAGGAGGTCCTTG
CATCTCCCAGCTATGACTA->ATCTCCCAGCTATGACTAA
CATCTCGCAACTGTATTTA->ATCTCGCAACTGTATTTAG
CATGACAAATGGTCAATTA->ATGACAAATGGTCAATTAA
CATGAGATTACCGCGATGG->ATGAGATTACCGCGATGGT
CATGATGATAGGGAACAAC->ATGATGATAGGGAACAACC
CATGCAAATTATAGAGCCT->ATGCAAATTATAGAGCCTC
CATGGAATGGCAGTAAGAT->ATGGAATGGCAGTAAGATA
CATGGGTTTCCCGCTCCTG->ATGGGTTTCCCGCTCCTGG
CATTAATTATCAACACTGT->ATTAATTATCAACACTGTA
CATTCACACACAAAGCCAA->ATTCACACACAAAGCCAAG
CATTCAGCAGCAAGCACCA->ATTCAGCAGCAAGCACCAC
CATTCCACCGATAGCGTTG->ATTCCACCGATAGCGTTGC
CATTGCGGTGGAACACGAC->ATTGCGGTGGAACACGACA
CATTGTCTGCGAGGTAGCA->ATTGTCTGCGAGGTAGCAT
CATTTAGCCCCCCCGCCCC->ATTTAGCCCCCCCGCCCCT
CATTTAGGTTTTATAAATC->ATTTAGGTTTTATAAATCA
CATTTGTTGTTGGCATTTA->ATTTGTTGTTGGCATTTAG
CCAAAATTTCGAGAGGCAT->CAAAATTTCGAGAGGCATG
CCAAACAGTAGGAATGTTT->CAAACAGTAGGAATGTTTG
CCAAATCACGACCGCAGCT->CAAATCACGACCGCAGCTA
CCAACAACTGGTAAAGCCC->CAACAACTGGTAAAGCCCC
CCAACCACAGTGTGACGAA->CAACCACAGTGTGACGAAA
CCAAGGAGGTCCTTGGCCC->CAAGGAGGTCCTTGGCCCC
CCAAGGTTTGTGACTGATT->CAAGGTTTGTGACTGATTC
CCAAGTTTCACTACCGCTC->CAAGTTTCACTACCGCTCA
CCAATAATGTATAAGAGAC->CAATAATGTATAAGAGACT
CCAATCTCGTTCACAAAGT->CAATCTCGTTCACAAAGTA
CCACAGCCACGAGCATCCA->CACAGCCACGAGCATCCAA
CCACAGTGTGACGAAAAAA->CACAGTGTGACGAAAAAAA
CCACCGATAGCGTTGCTAG->CACCGATAGCGTTGCTAGT
CCACCGTTATTTCCAGACG->CACCGTTATTTCCAGACGC
CCACCTGTCGCTGCTCGAA->CACCTGTCGCTGCTCGAAA
CCACGAGCATCCAACCACA->CACGAGCATCCAACCACAG
CCACGCTTATATGGAGAGA->CACGCTTATATGGAGAGAT
CCACTGATCCAATCTCGTT->CACTGATCCAATCTCGTTC
CCACTGGTCGCCGAGTATC->CACTGGTCGCCGAGTATCA
CCACTGGTGGCCAGTGGGG->CACTGGTGGCCAGTGGGGG
CCACTGTCCATCATCAAAC->CACTGTCCATCATCAAACA
CCAGACGCAGATGAATGAG->CAGACGCAGATGAATGAGG
CCAGCCTACCTCTGACGCT->CAGCCTACCTCTGACGCTT
CCAGCGGTAGCCTAAATAC->CAGCGGTAGCCTAAATACT
CCAGCTATGACTAATCTAA->CAGCTATGACTAATCTAAG
CCAGGAAGAGCCAGTCCAC->CAGGAAGAGCCAGTCCACT
CCAGGAGGCCTATAGGGAG->CAGGAGGCCTATAGGGAGA
CCAGGCCAGGAGGCCTATA->CAGGCCAGGAGGCCTATAG
CCAGGCCATCCGAATGCAC->CAGGCCATCCGAATGCACG
CCAGGGCGCCAACAACTGG->CAGGGCGCCAACAACTGGT
CCAGGGCTCCAGGAAGAGC->CAGGGCTCCAGGAAGAGCC
CCAGGGTCTTATACATTGT->CAGGGTCTTATACATTGTC
CCAGTCCACTGATCCAATC->CAGTCCACTGATCCAATCT
CCAGTGGGGGACTCGCAGT->CAGTGGGGGACTCGCAGTG
CCATAGCTCCGGGGGCCAC->CATAGCTCCGGGGGCCACG
CCATATGGTCGCGAGTACT->CATATGGTCGCGAGTACTT
CCATCATCAAACAGTGGAT->CATCATCAAACAGTGGATA
CCATCCGAATGCACGACAT->CATCCGAATGCACGACATC
CCATCCTAATCTTAGGTGC->CATCCTAATCTTAGGTGCA
CCATCGAAGGAATGGCCGG->CATCGAAGGAATGGCCGGG
CCATGCAAATTATAGAGCC->CATGCAAATTATAGAGCCT
CCATGGAATGGCAGTAAGA->CATGGAATGGCAGTAAGAT
CCATTTAGGTTTTATAAAT->CATTTAGGTTTTATAAATC
CCCACTGGTGGCCAGTGGG->CCACTGGTGGCCAGTGGGG
CCCAGCGGTAGCCTAAATA->CCAGCGGTAGCCTAAATAC
CCCAGCTATGACTAATCTA->CCAGCTATGACTAATCTAA
CCCAGGCCAGGAGGCCTAT->CCAGGCCAGGAGGCCTATA
CCCAGGGCTCCAGGAAGAG->CCAGGGCTCCAGGAAGAGC
CCCAGGGTCTTATACATTG->CCAGGGTCTTATACATTGT
CCCATCCTAATCTTAGGTG->CCATCCTAATCTTAGGTGC
CCCATTTAGGTTTTATAAA->CCATTTAGGTTTTATAAAT
CCCCACTGGTGGCCAGTGG->CCCACTGGTGGCCAGTGGG
CCCCCCCGCCCCTACCAAA->CCCCCCGCCCCTACCAAAC
CCCCCCGCCCCTACCAAAC->CCCCCGCCCCTACCAAACA
CCCCCGCCCCTACCAAACA->CCCCGCCCCTACCAAACAG
CCCCCTCCCATTTAGGTTT->CCCCTCCCATTTAGGTTTT
CCCCCTGTTGAGAACCTGA->CCCCTGTTGAGAACCTGAC
CCCCGCACCAAATCACGAC->CCCGCACCAAATCACGACC
CCCCGCCCCTACCAAACAG->CCCGCCCCTACCAAACAGT
CCCCGTATCCACAGCCACG->CCCGTATCCACAGCCACGA
CCCCGTCTCATCCTTGTCG->CCCGTCTCATCCTTGTCGT
CCCCTACCAAACAGTAGGA->CCCTACCAAACAGTAGGAA
CCCCTCCATGCAAATTATA->CCCTCCATGCAAATTATAG
CCCCTCCCATTTAGGTTTT->CCCTCCCATTTAGGTTTTA
CCCCTCTCTATTTTAGAGG->CCCTCTCTATTTTAGAGGG
CCCCTGTTGAGAACCTGAC->CCCTGTTGAGAACCTGACA
CCCGAGGGGCGCGTGCGAT->CCGAGGGGCGCGTGCGATA
CCCGCACCAAATCACGACC->CCGCACCAAATCACGACCG
CCCGCCCCTACCAAACAGT->CCGCCCCTACCAAACAGTA
CCCGCTCCTGGGGCCTGCT->CCGCTCCTGGGGCCTGCTG
CCCGGTTCGCAAACGGCAA->CCGGTTCGCAAACGGCAAC
CCCGTATCCACAGCCACGA->CCGTATCCACAGCCACGAG
CCCGTCTCATCCTTGTCGT->CCGTCTCATCCTTGTCGTC
CCCGTCTGCTAACGGGGCT->CCGTCTGCTAACGGGGCTA
CCCTACCAAACAGTAGGAA->CCTACCAAACAGTAGGAAT
CCCTAGTGTATTTGAGAAT->CCTAGTGTATTTGAGAATC
CCCTCCATGCAAATTATAG->CCTCCATGCAAATTATAGA
CCCTCCCATTTAGGTTTTA->CCTCCCATTTAGGTTTTAT
CCCTCTCTATTTTAGAGGG->CCTCTCTATTTTAGAGGGA
CCCTGACACTAAGACCGGA->CCTGACACTAAGACCGGAA
CCCTGTTGAGAACCTGACA->CCTGTTGAGAACCTGACAG
CCCTTAGATCAGCTGGGCT->CCTTAGATCAGCTGGGCTT
CCCTTTTGGTCCTTATGAC->CCTTTTGGTCCTTATGACC
CCGAAACGGAATCTGGACT->CGAAACGGAATCTGGACTG
CCGAACTAATGGCATAGTC->CGAACTAATGGCATAGTCA
CCGAATGCACGACATCGGC->CGAATGCACGACATCGGCC
CCGAATTAACTTCAGGTAC->CGAATTAACTTCAGGTACT
CCGAGCCCTTAGATCAGCT->CGAGCCCTTAGATCAGCTG
CCGAGGGGCGCGTGCGATA->CGAGGGGCGCGTGCGATAA
CCGAGTATCAGGTCCTCAC->CGAGTATCAGGTCCTCACG
CCGATAGCGTTGCTAGTGT->CGATAGCGTTGCTAGTGTC
CCGCACCAAATCACGACCG->CGCACCAAATCACGACCGC
CCGCAGCTAACATACGCCA->CGCAGCTAACATACGCCAT
CCGCAGCTAACCGCCCCAC->CGCAGCTAACCGCCCCACT
CCGCAGCTAACCTCAGAGT->CGCAGCTAACCTCAGAGTC
CCGCAGCTAACGTCTCAGT->CGCAGCTAACGTCTCAGTA
CCGCATAAGTCCCCCTCCC->CGCATAAGTCCCCCTCCCA
CCGCCCCACTGGTGGCCAG->CGCCCCACTGGTGGCCAGT
CCGCCCCTACCAAACAGTA->CGCCCCTACCAAACAGTAG
CCGCGATGGTAACGCGGAA->CGCGATGGTAACGCGGAAC
CCGCTCATACATGGGTTTC->CGCTCATACATGGGTTTCC
CCGCTCCTGGGGCCTGCTG->CGCTCCTGGGGCCTGCTGG
CCGGAACGCTTATTGCCTC->CGGAACGCTTATTGCCTCA
CCGGATGTGAGTCCAGGGC->CGGATGTGAGTCCAGGGCG
CCGGCACGTCGCCCTGACA->CGGCACGTCGCCCTGACAC
CCGGGGAGGGGCCCATCCT->CGGGGAGGGGCCCATCCTA
CCGGGGGCCACGCTTATAT->CGGGGGCCACGCTTATATG
CCGGTTCGCAAACGGCAAC->CGGTTCGCAAACGGCAACT
CCGTAGTACTAAACTAAAA->CGTAGTACTAAACTAAAAG
CCGTATCCACAGCCACGAG->CGTATCCACAGCCACGAGC
CCGTCATTCACACACAAAG->CGTCATTCACACACAAAGC
CCGTCTCATCCTTGTCGTC->CGTCTCATCCTTGTCGTCT
CCGTCTGCTAACGGGGCTA->CGTCTGCTAACGGGGCTAC
CCGTCTTCTTGGAGATGGT->CGTCTTCTTGGAGATGGTT
CCGTTATTTCCAGACGCAG->CGTTATTTCCAGACGCAGA
CCTAAATACTATCGCCCGA->CTAAATACTATCGCCCGAG
CCTAATCTTAGGTGCAGCC->CTAATCTTAGGTGCAGCCA
CCTACCAAACAGTAGGAAT->CTACCAAACAGTAGGAATG
CCTACCTCTGACGCTTGGA->CTACCTCTGACGCTTGGAT
CCTAGTGTATTTGAGAATC->CTAGTGTATTTGAGAATCA
CCTATAGGGAGAGACTAGC->CTATAGGGAGAGACTAGCG
CCTATGGGTTTTGTGAATC->CTATGGGTTTTGTGAATCG
CCTCACAAGCTCGTTGGAG->CTCACAAGCTCGTTGGAGT
CCTCACCCGGTTCGCAAAC->CTCACCCGGTTCGCAAACG
CCTCACGCCGCATAAGTCC->CTCACGCCGCATAAGTCCC
CCTCAGAGTCGGTACCCCG->CTCAGAGTCGGTACCCCGT
CCTCCATGCAAATTATAGA->CTCCATGCAAATTATAGAG
CCTCCCATTTAGGTTTTAT->CTCCCATTTAGGTTTTATA
CCTCGTCCAAAATTTCGAG->CTCGTCCAAAATTTCGAGA
CCTCTCTATTTTAGAGGGA->CTCTCTATTTTAGAGGGAG
CCTCTGACGCTTGGATGAC->CTCTGACGCTTGGATGACC
CCTGACACTAAGACCGGAA->CTGACACTAAGACCGGAAC
CCTGACAGCTGTTCTGCGA->CTGACAGCTGTTCTGCGAT
CCTGATACTAGACTCAGTG->CTGATACTAGACTCAGTGC
CCTGCTGGAGCGAAGAGGC->CTGCTGGAGCGAAGAGGCT
CCTGGCCCAGGCCAGGAGG->CTGGCCCAGGCCAGGAGGC
CCTGGGGCCTGCTGGAGCG->CTGGGGCCTGCTGGAGCGA
CCTGGTCCGAAACGGAATC->CTGGTCCGAAACGGAATCT
CCTGTCGCTGCTCGAAATT->CTGTCGCTGCTCGAAATTA
CCTGTTGAGAACCTGACAG->CTGTTGAGAACCTGACAGC
CCTTAAGGCTGGCCGAGCC->CTTAAGGCTGGCCGAGCCC
CCTTAGATCAGCTGGGCTT->CTTAGATCAGCTGGGCTTG
CCTTATGACCAGCCTACCT->CTTATGACCAGCCTACCTC
CCTTGAGTAATCAGGTGGT->CTTGAGTAATCAGGTGGTT
CCTTGGCCCCTCCATGCAA->CTTGGCCCCTCCATGCAAA
CCTTGTCGTCTTTTGCGCT->CTTGTCGTCTTTTGCGCTG
CCTTTTGGTCCTTATGACC->CTTTTGGTCCTTATGACCA
CGAAAAAAAATAGCAGATA->GAAAAAAAATAGCAGATAA
CGAAAAAGGGCCACTGTCC->GAAAAAGGGCCACTGTCCA
CGAAACGGAATCTGGACTG->GAAACGGAATCTGGACTGA
CGAAATTACTGTCAACTGT->GAAATTACTGTCAACTGTA
CGAACCCTTTTGGTCCTTA->GAACCCTTTTGGTCCTTAT
CGAACGATTACAATATGCG->GAACGATTACAATATGCGA
CGAACTAATGGCATAGTCA->GAACTAATGGCATAGTCAT
CGAACTTTCCCAGGGCTCC->GAACTTTCCCAGGGCTCCA
CGAAGAGGCTCTCATTAAT->GAAGAGGCTCTCATTAATT
CGAAGGAATGGCCGGGGAG->GAAGGAATGGCCGGGGAGG
CGAATGCACGACATCGGCC->GAATGCACGACATCGGCCG
CGAATTAACTTCAGGTACT->GAATTAACTTCAGGTACTG
CGACAGCGGGCATCTCCAA->GACAGCGGGCATCTCCAAG
CGACAGGAATCACGACCGC->GACAGGAATCACGACCGCA
CGACATCGGCCGGATGTGA->GACATCGGCCGGATGTGAG
CGACCGCAGCTAACATACG->GACCGCAGCTAACATACGC
CGACCGCAGCTAACCGCCC->GACCGCAGCTAACCGCCCC
CGACCGCAGCTAACCTCAG->GACCGCAGCTAACCTCAGA
CGACCGCAGCTAACGTCTC->GACCGCAGCTAACGTCTCA
CGACCTGGCCCAGGCCAGG->GACCTGGCCCAGGCCAGGA
CGACTCGGTAGGAAAATGC->GACTCGGTAGGAAAATGCA
CGAGAGGCATGACAAATGG->GAGAGGCATGACAAATGGT
CGAGCATCCAACCACAGTG->GAGCATCCAACCACAGTGT
CGAGCCCTTAGATCAGCTG->GAGCCCTTAGATCAGCTGG
CGAGGCGAACTTTCCCAGG->GAGGCGAACTTTCCCAGGG
CGAGGGAAAGTAACGGGGA->GAGGGAAAGTAACGGGGAA
CGAGGGGCGCGTGCGATAA->GAGGGGCGCGTGCGATAAA
CGAGGTAGCATTCAGCAGC->GAGGTAGCATTCAGCAGCA
CGAGTACTTGACATTTGTT->GAGTACTTGACATTTGTTG
CGAGTATCAGGTCCTCACG->GAGTATCAGGTCCTCACGC
CGATAAAAGGGAACTCTAG->GATAAAAGGGAACTCTAGC
CGATAGCGTTGCTAGTGTC->GATAGCGTTGCTAGTGTCA
CGATCGCGATGCGCTCCCC->GATCGCGATGCGCTCCCCG
CGATGCGCTCCCCGTATCC->GATGCGCTCCCCGTATCCA
CGATGGTAACGCGGAACTC->GATGGTAACGCGGAACTCG
CGATGGTTCGGCAGGATGA->GATGGTTCGGCAGGATGAA
CGATTACAATATGCGAAAA->GATTACAATATGCGAAAAA
CGATTGATTCACCTATGGG->GATTGATTCACCTATGGGT
CGCAAACGGCAACTCCCCT->GCAAACGGCAACTCCCCTC
CGCAACTGTATTTAGGTGC->GCAACTGTATTTAGGTGCT
CGCAAGTGCTCAATCACGA->GCAAGTGCTCAATCACGAC
CGCACCAAATCACGACCGC->GCACCAAATCACGACCGCA
CGCAGATGAATGAGGGGGG->GCAGATGAATGAGGGGGGA
CGCAGCTAACATACGCCAT->GCAGCTAACATACGCCATA
CGCAGCTAACCGCCCCACT->GCAGCTAACCGCCCCACTG
CGCAGCTAACCTCAGAGTC->GCAGCTAACCTCAGAGTCG
CGCAGCTAACGTCTCAGTA->GCAGCTAACGTCTCAGTAG
CGCAGTGGGCCCAGCGGTA->GCAGTGGGCCCAGCGGTAG
CGCAGTTAAGATGTACGTT->GCAGTTAAGATGTACGTTC
CGCATAAGTCCCCCTCCCA->GCATAAGTCCCCCTCCCAT
CGCCAACAACTGGTAAAGC->GCCAACAACTGGTAAAGCC
CGCCATATGGTCGCGAGTA->GCCATATGGTCGCGAGTAC
CGCCATCGAAGGAATGGCC->GCCATCGAAGGAATGGCCG
CGCCCCACTGGTGGCCAGT->GCCCCACTGGTGGCCAGTG
CGCCCCTACCAAACAGTAG->GCCCCTACCAAACAGTAGG
CGCCCGAGGGGCGCGTGCG->GCCCGAGGGGCGCGTGCGA
CGCCCTGACACTAAGACCG->GCCCTGACACTAAGACCGG
CGCCGAGTATCAGGTCCTC->GCCGAGTATCAGGTCCTCA
CGCCGCATAAGTCCCCCTC->GCCGCATAAGTCCCCCTCC
CGCCTCACAAGCTCGTTGG->GCCTCACAAGCTCGTTGGA
CGCCTGATACTAGACTCAG->GCCTGATACTAGACTCAGT
CGCGAACGATTACAATATG->GCGAACGATTACAATATGC
CGCGAGTACTTGACATTTG->GCGAGTACTTGACATTTGT
CGCGATGCGCTCCCCGTAT->GCGATGCGCTCCCCGTATC
CGCGATGGTAACGCGGAAC->GCGATGGTAACGCGGAACT
CGCGCTGATAACGACAGGA->GCGCTGATAACGACAGGAA
CGCGCTGCGCAAGTGCTCA->GCGCTGCGCAAGTGCTCAA
CGCGCTGGCCCCGCACCAA->GCGCTGGCCCCGCACCAAA
CGCGCTGTATGCGTGGGTA->GCGCTGTATGCGTGGGTAA
CGCGGAACTCGCGAACGAT->GCGGAACTCGCGAACGATT
CGCGTAGGGGACGAGGCGA->GCGTAGGGGACGAGGCGAA
CGCGTGCGATAAAAGGGAA->GCGTGCGATAAAAGGGAAC
CGCTCATACATGGGTTTCC->GCTCATACATGGGTTTCCC
CGCTCCCCGTATCCACAGC->GCTCCCCGTATCCACAGCC
CGCTCCTGGGGCCTGCTGG->GCTCCTGGGGCCTGCTGGA
CGCTGATAACGACAGGAAT->GCTGATAACGACAGGAATC
CGCTGCGCAAGTGCTCAAT->GCTGCGCAAGTGCTCAATC
CGCTGCTCAATCCGAACTA->GCTGCTCAATCCGAACTAA
CGCTGCTCGAAATTACTGT->GCTGCTCGAAATTACTGTC
CGCTGGCCCCGCACCAAAT->GCTGGCCCCGCACCAAATC
CGCTGGTGGAGAGACTAGC->GCTGGTGGAGAGACTAGCG
CGCTGTATGCGTGGGTAAT->GCTGTATGCGTGGGTAATC
CGCTTATATGGAGAGATCT->GCTTATATGGAGAGATCTG
CGCTTATTGCCTCACCCGG->GCTTATTGCCTCACCCGGT
CGCTTGGATGACCTTGAGT->GCTTGGATGACCTTGAGTA
CGGAACGCTTATTGCCTCA->GGAACGCTTATTGCCTCAC
CGGAACTCGCGAACGATTA->GGAACTCGCGAACGATTAC
CGGAATCTGGACTGATTTA->GGAATCTGGACTGATTTAG
CGGACACCGGCACGTCGCC->GGACACCGGCACGTCGCCC
CGGAGAGACTAGCGCGCTG->GGAGAGACTAGCGCGCTGC
CGGATGTGAGTCCAGGGCG->GGATGTGAGTCCAGGGCGC
CGGCAACTCCCCTCTCTAT->GGCAACTCCCCTCTCTATT
CGGCACGTCGCCCTGACAC->GGCACGTCGCCCTGACACT
CGGCAGGATGAACGAACCC->GGCAGGATGAACGAACCCT
CGGCCGGATGTGAGTCCAG->GGCCGGATGTGAGTCCAGG
CGGGAGTAGACGACTCGGT->GGGAGTAGACGACTCGGTA
CGGGCATCTCCAAGGAGGT->GGGCATCTCCAAGGAGGTC
CGGGGAAGGAGAGACTAGC->GGGGAAGGAGAGACTAGCG
CGGGGAGGGGCCCATCCTA->GGGGAGGGGCCCATCCTAA
CGGGGCTACATCTCCCAGC->GGGGCTACATCTCCCAGCT
CGGGGGCCACGCTTATATG->GGGGGCCACGCTTATATGG
CGGTACCCCGTCTCATCCT->GGTACCCCGTCTCATCCTT
CGGTAGCCTAAATACTATC->GGTAGCCTAAATACTATCG
CGGTAGGAAAATGCATGAG->GGTAGGAAAATGCATGAGA
CGGTGGAACACGACAGCGG->GGTGGAACACGACAGCGGG
CGGTTCGCAAACGGCAACT->GGTTCGCAAACGGCAACTC
CGTAGGGGACGAGGCGAAC->GTAGGGGACGAGGCGAACT
CGTAGTACTAAACTAAAAG->GTAGTACTAAACTAAAAGT
CGTATCCACAGCCACGAGC->GTATCCACAGCCACGAGCA
CGTATCGCCTGATACTAGA->GTATCGCCTGATACTAGAC
CGTCAGGCGGCACTAGCAA->GTCAGGCGGCACTAGCAAA
CGTCATTCACACACAAAGC->GTCATTCACACACAAAGCC
CGTCCAAAATTTCGAGAGG->GTCCAAAATTTCGAGAGGC
CGTCCACTGGTCGCCGAGT->GTCCACTGGTCGCCGAGTA
CGTCGATTGATTCACCTAT->GTCGATTGATTCACCTATG
CGTCGCCCTGACACTAAGA->GTCGCCCTGACACTAAGAC
CGTCTCAGTAGAGTTTGCT->GTCTCAGTAGAGTTTGCTA
CGTCTCATCCTTGTCGTCT->GTCTCATCCTTGTCGTCTT
CGTCTGCTAACGGGGCTAC->GTCTGCTAACGGGGCTACA
CGTCTTCTTGGAGATGGTT->GTCTTCTTGGAGATGGTTC
CGTCTTTTGCGCTGCTCAA->GTCTTTTGCGCTGCTCAAT
CGTGCGATAAAAGGGAACT->GTGCGATAAAAGGGAACTC
CGTGGGTAATCACGACCGC->GTGGGTAATCACGACCGCA
CGTTAAGGTTGCCGTAGTA->GTTAAGGTTGCCGTAGTAC
CGTTATTCTGTCAGCACGT->GTTATTCTGTCAGCACGTC
CGTTATTTCCAGACGCAGA->GTTATTTCCAGACGCAGAT
CGTTCACAAAGTATTTCAT->GTTCACAAAGTATTTCATT
CGTTCTTACTCGCCATCGA->GTTCTTACTCGCCATCGAA
CGTTGCTAGTGTCAACAGT->GTTGCTAGTGTCAACAGTC
CGTTGGAGTTTGCAACTAG->GTTGGAGTTTGCAACTAGC
CTAAAAGTCCAAGGTTTGT->TAAAAGTCCAAGGTTTGTG
CTAAACTAAAAGTCCAAGG->TAAACTAAAAGTCCAAGGT
CTAAATACTATCGCCCGAG->TAAATACTATCGCCCGAGG
CTAAATTTAGTTGGTAACG->TAAATTTAGTTGGTAACGT
CTAACATACGCCATATGGT->TAACATACGCCATATGGTC
CTAACCGCCCCACTGGTGG->TAACCGCCCCACTGGTGGC
CTAACCTCAGAGTCGGTAC->TAACCTCAGAGTCGGTACC
CTAACGGGGCTACATCTCC->TAACGGGGCTACATCTCCC
CTAACGTCTCAGTAGAGTT->TAACGTCTCAGTAGAGTTT
CTAAGACCGGAACGCTTAT->TAAGACCGGAACGCTTATT
CTAAGCCTTAAGGCTGGCC->TAAGCCTTAAGGCTGGCCG
CTAATCTAAGCCTTAAGGC->TAATCTAAGCCTTAAGGCT
CTAATCTTAGGTGCAGCCA->TAATCTTAGGTGCAGCCAT
CTAATGGCATAGTCATGAT->TAATGGCATAGTCATGATG
CTACATCTCCCAGCTATGA->TACATCTCCCAGCTATGAC
CTACCAAACAGTAGGAATG->TACCAAACAGTAGGAATGT
CTACCGCTCATACATGGGT->TACCGCTCATACATGGGTT
CTACCTCTGACGCTTGGAT->TACCTCTGACGCTTGGATG
CTAGACTCAGTGCCGTCTT->TAGACTCAGTGCCGTCTTC
CTAGCGCGCTGATAACGAC->TAGCGCGCTGATAACGACA
CTAGCGCGCTGCGCAAGTG->TAGCGCGCTGCGCAAGTGC
CTAGCGCGCTGGCCCCGCA->TAGCGCGCTGGCCCCGCAC
CTAGCGCGCTGTATGCGTG->TAGCGCGCTGTATGCGTGG
CTAGCGTCAGGCGGCACTA->TAGCGTCAGGCGGCACTAG
CTAGCTTGATCCAGGCCAT->TAGCTTGATCCAGGCCATC
CTAGGCCATAGCTCCGGGG->TAGGCCATAGCTCCGGGGG
CTAGGCGCGTAGGGGACGA->TAGGCGCGTAGGGGACGAG
CTAGTGTATTTGAGAATCA->TAGTGTATTTGAGAATCAG
CTAGTGTCAACAGTCAGCA->TAGTGTCAACAGTCAGCAA
CTATAGGGAGAGACTAGCG->TATAGGGAGAGACTAGCGC
CTATCGCCCGAGGGGCGCG->TATCGCCCGAGGGGCGCGT
CTATGACTAATCTAAGCCT->TATGACTAATCTAAGCCTT
CTATGGGTTTTGTGAATCG->TATGGGTTTTGTGAATCGC
CTATTTTAGAGGGAGGGCT->TATTTTAGAGGGAGGGCTG
CTCAATCACGACCGCAGCT->TCAATCACGACCGCAGCTA
CTCAATCCGAACTAATGGC->TCAATCCGAACTAATGGCA
CTCACAAGCTCGTTGGAGT->TCACAAGCTCGTTGGAGTT
CTCACCCGGTTCGCAAACG->TCACCCGGTTCGCAAACGG
CTCACGCCGCATAAGTCCC->TCACGCCGCATAAGTCCCC
CTCAGAGTCGGTACCCCGT->TCAGAGTCGGTACCCCGTC
CTCAGTAGAGTTTGCTAGG->TCAGTAGAGTTTGCTAGGC
CTCAGTGCCGTCTTCTTGG->TCAGTGCCGTCTTCTTGGA
CTCATACATGGGTTTCCCG->TCATACATGGGTTTCCCGC
CTCATCCTTGTCGTCTTTT->TCATCCTTGTCGTCTTTTG
CTCATTAATTATCAACACT->TCATTAATTATCAACACTG
CTCCAAGGAGGTCCTTGGC->TCCAAGGAGGTCCTTGGCC
CTCCAGGAAGAGCCAGTCC->TCCAGGAAGAGCCAGTCCA
CTCCATGCAAATTATAGAG->TCCATGCAAATTATAGAGC
CTCCCAGCTATGACTAATC->TCCCAGCTATGACTAATCT
CTCCCATTTAGGTTTTATA->TCCCATTTAGGTTTTATAA
CTCCCCGTATCCACAGCCA->TCCCCGTATCCACAGCCAC
CTCCCCTCTCTATTTTAGA->TCCCCTCTCTATTTTAGAG
CTCCGGGGGCCACGCTTAT->TCCGGGGGCCACGCTTATA
CTCCTGGGGCCTGCTGGAG->TCCTGGGGCCTGCTGGAGC
CTCCTGGTCCGAAACGGAA->TCCTGGTCCGAAACGGAAT
CTCGAAATTACTGTCAACT->TCGAAATTACTGTCAACTG
CTCGATGGTTCGGCAGGAT->TCGATGGTTCGGCAGGATG
CTCGCAACTGTATTTAGGT->TCGCAACTGTATTTAGGTG
CTCGCAGTGGGCCCAGCGG->TCGCAGTGGGCCCAGCGGT
CTCGCCATCGAAGGAATGG->TCGCCATCGAAGGAATGGC
CTCGCGAACGATTACAATA->TCGCGAACGATTACAATAT
CTCGGGAGTAGACGACTCG->TCGGGAGTAGACGACTCGG
CTCGGTAGGAAAATGCATG->TCGGTAGGAAAATGCATGA
CTCGTCCAAAATTTCGAGA->TCGTCCAAAATTTCGAGAG
CTCGTTCACAAAGTATTTC->TCGTTCACAAAGTATTTCA
CTCGTTGGAGTTTGCAACT->TCGTTGGAGTTTGCAACTA
CTCTAGCTTGATCCAGGCC->TCTAGCTTGATCCAGGCCA
CTCTATTTTAGAGGGAGGG->TCTATTTTAGAGGGAGGGC
CTCTCATTAATTATCAACA->TCTCATTAATTATCAACAC
CTCTCTATTTTAGAGGGAG->TCTCTATTTTAGAGGGAGG
CTCTGACGCTTGGATGACC->TCTGACGCTTGGATGACCT
CTCTGCACATAACACGTTA->TCTGCACATAACACGTTAA
CTGACACTAAGACCGGAAC->TGACACTAAGACCGGAACG
CTGACAGCTGTTCTGCGAT->TGACAGCTGTTCTGCGATC
CTGACCGTCATTCACACAC->TGACCGTCATTCACACACA
CTGACGCTTGGATGACCTT->TGACGCTTGGATGACCTTG
CTGATAACGACAGGAATCA->TGATAACGACAGGAATCAC
CTGATACTAGACTCAGTGC->TGATACTAGACTCAGTGCC
CTGATCCAATCTCGTTCAC->TGATCCAATCTCGTTCACA
CTGATTCTGGTTAGGCGGA->TGATTCTGGTTAGGCGGAG
CTGATTTAGCCACCTGTCG->TGATTTAGCCACCTGTCGC
CTGCACATAACACGTTAAG->TGCACATAACACGTTAAGG
CTGCGAGGTAGCATTCAGC->TGCGAGGTAGCATTCAGCA
CTGCGATCGCGATGCGCTC->TGCGATCGCGATGCGCTCC
CTGCGCAAGTGCTCAATCA->TGCGCAAGTGCTCAATCAC
CTGCTAACGGGGCTACATC->TGCTAACGGGGCTACATCT
CTGCTCAATCCGAACTAAT->TGCTCAATCCGAACTAATG
CTGCTCGAAATTACTGTCA->TGCTCGAAATTACTGTCAA
CTGCTGGAGCGAAGAGGCT->TGCTGGAGCGAAGAGGCTC
CTGGACTGATTTAGCCACC->TGGACTGATTTAGCCACCT
CTGGAGCGAAGAGGCTCTC->TGGAGCGAAGAGGCTCTCA
CTGGCCCAGGCCAGGAGGC->TGGCCCAGGCCAGGAGGCC
CTGGCCCCGCACCAAATCA->TGGCCCCGCACCAAATCAC
CTGGCCGAGCCCTTAGATC->TGGCCGAGCCCTTAGATCA
CTGGCGTCCACTGGTCGCC->TGGCGTCCACTGGTCGCCG
CTGGGCTTGAGCACTTCTC->TGGGCTTGAGCACTTCTCT
CTGGGGCCTGCTGGAGCGA->TGGGGCCTGCTGGAGCGAA
CTGGTAAAGCCCCCTGTTG->TGGTAAAGCCCCCTGTTGA
CTGGTCCGAAACGGAATCT->TGGTCCGAAACGGAATCTG
CTGGTCGCCGAGTATCAGG->TGGTCGCCGAGTATCAGGT
CTGGTGGAGAGACTAGCGC->TGGTGGAGAGACTAGCGCG
CTGGTGGCCAGTGGGGGAC->TGGTGGCCAGTGGGGGACT
CTGGTTAGGCGGAGAGACT->TGGTTAGGCGGAGAGACTA
CTGTATGCGTGGGTAATCA->TGTATGCGTGGGTAATCAC
CTGTATGCTAAATTTAGTT->TGTATGCTAAATTTAGTTG
CTGTATTCTCGATGGTTCG->TGTATTCTCGATGGTTCGG
CTGTATTTAGGTGCTCCTG->TGTATTTAGGTGCTCCTGG
CTGTCAACTGTATGCTAAA->TGTCAACTGTATGCTAAAT
CTGTCAGCACGTCGATTGA->TGTCAGCACGTCGATTGAT
CTGTCCATCATCAAACAGT->TGTCCATCATCAAACAGTG
CTGTCCGAATTAACTTCAG->TGTCCGAATTAACTTCAGG
CTGTCGCTGCTCGAAATTA->TGTCGCTGCTCGAAATTAC
CTGTCGTTATTCTGTCAGC->TGTCGTTATTCTGTCAGCA
CTGTTCTGCGATCGCGATG->TGTTCTGCGATCGCGATGC
CTGTTCTGGCGTCCACTGG->TGTTCTGGCGTCCACTGGT
CTGTTGAGAACCTGACAGC->TGTTGAGAACCTGACAGCT
CTTAAGGCTGGCCGAGCCC->TTAAGGCTGGCCGAGCCCT
CTTACTCGCCATCGAAGGA->TTACTCGCCATCGAAGGAA
CTTAGATCAGCTGGGCTTG->TTAGATCAGCTGGGCTTGA
CTTAGGTGCAGCCATGGAA->TTAGGTGCAGCCATGGAAT
CTTATACATTGTCTGCGAG->TTATACATTGTCTGCGAGG
CTTATATGGAGAGATCTGT->TTATATGGAGAGATCTGTC
CTTATGACCAGCCTACCTC->TTATGACCAGCCTACCTCT
CTTATTGCCTCACCCGGTT->TTATTGCCTCACCCGGTTC
CTTCAGGTACTGTTCTGGC->TTCAGGTACTGTTCTGGCG
CTTCTCTGCACATAACACG->TTCTCTGCACATAACACGT
CTTCTTGGAGATGGTTCAA->TTCTTGGAGATGGTTCAAA
CTTGACATTTGTTGTTGGC->TTGACATTTGTTGTTGGCA
CTTGAGCACTTCTCTGCAC->TTGAGCACTTCTCTGCACA
CTTGAGTAATCAGGTGGTT->TTGAGTAATCAGGTGGTTC
CTTGATCCAGGCCATCCGA->TTGATCCAGGCCATCCGAA
CTTGGAGATGGTTCAAATG->TTGGAGATGGTTCAAATGC
CTTGGATGACCTTGAGTAA->TTGGATGACCTTGAGTAAT
CTTGGCCCCTCCATGCAAA->TTGGCCCCTCCATGCAAAT
CTTGTCGTCTTTTGCGCTG->TTGTCGTCTTTTGCGCTGC
CTTTCCCAGGGCTCCAGGA->TTTCCCAGGGCTCCAGGAA
CTTTGCCCGTCTGCTAACG->TTTGCCCGTCTGCTAACGG
CTTTTGCGCTGCTCAATCC->TTTTGCGCTGCTCAATCCG
CTTTTGGTCCTTATGACCA->TTTTGGTCCTTATGACCAG
GAAAAAAAATAGCAGATAA->AAAAAAAATAGCAGATAAG
GAAAAAGGGCCACTGTCCA->AAAAAGGGCCACTGTCCAT
GAAAATGCATGAGATTACC->AAAATGCATGAGATTACCG
GAAAATTTCCCAGGGTCTT->AAAATTTCCCAGGGTCTTA
GAAACGGAATCTGGACTGA->AAACGGAATCTGGACTGAT
GAAAGTAACGGGGAAGGAG->AAAGTAACGGGGAAGGAGA
GAAATTACTGTCAACTGTA->AAATTACTGTCAACTGTAT
GAACAACCAATAATGTATA->AACAACCAATAATGTATAA
GAACACGACAGCGGGCATC->AACACGACAGCGGGCATCT
GAACCCTTTTGGTCCTTAT->AACCCTTTTGGTCCTTATG
GAACCTGACAGCTGTTCTG->AACCTGACAGCTGTTCTGC
GAACGAACCCTTTTGGTCC->AACGAACCCTTTTGGTCCT
GAACGATTACAATATGCGA->AACGATTACAATATGCGAA
GAACGCTTATTGCCTCACC->AACGCTTATTGCCTCACCC
GAACTAATGGCATAGTCAT->AACTAATGGCATAGTCATG
GAACTCGCGAACGATTACA->AACTCGCGAACGATTACAA
GAACTCTAGCTTGATCCAG->AACTCTAGCTTGATCCAGG
GAACTTTCCCAGGGCTCCA->AACTTTCCCAGGGCTCCAG
GAAGAGCCAGTCCACTGAT->AAGAGCCAGTCCACTGATC
GAAGAGGCTCTCATTAATT->AAGAGGCTCTCATTAATTA
GAAGGAATGGCCGGGGAGG->AAGGAATGGCCGGGGAGGG
GAAGGAGAGACTAGCGCGC->AAGGAGAGACTAGCGCGCT
GAATCACGACCGCAGCTAA->AATCACGACCGCAGCTAAC
GAATCAGTGAGAAAATTTC->AATCAGTGAGAAAATTTCC
GAATCGCAGTTAAGATGTA->AATCGCAGTTAAGATGTAC
GAATCTGGACTGATTTAGC->AATCTGGACTGATTTAGCC
GAATGAGGGGGGACTTTGC->AATGAGGGGGGACTTTGCC
GAATGCACGACATCGGCCG->AATGCACGACATCGGCCGG
GAATGGCAGTAAGATAAGG->AATGGCAGTAAGATAAGGG
GAATGGCCGGGGAGGGGCC->AATGGCCGGGGAGGGGCCC
GAATGTTTGGTCATCTCGC->AATGTTTGGTCATCTCGCA
GAATTAACTTCAGGTACTG->AATTAACTTCAGGTACTGT
GACAAATGGTCAATTAATC->ACAAATGGTCAATTAATCT
GACACCGGCACGTCGCCCT->ACACCGGCACGTCGCCCTG
GACACTAAGACCGGAACGC->ACACTAAGACCGGAACGCT
GACAGCGGGCATCTCCAAG->ACAGCGGGCATCTCCAAGG
GACAGCTGTTCTGCGATCG->ACAGCTGTTCTGCGATCGC
GACAGGAATCACGACCGCA->ACAGGAATCACGACCGCAG
GACATCGGCCGGATGTGAG->ACATCGGCCGGATGTGAGT
GACATTTGTTGTTGGCATT->ACATTTGTTGTTGGCATTT
GACCAGCCTACCTCTGACG->ACCAGCCTACCTCTGACGC
GACCGCAGCTAACATACGC->ACCGCAGCTAACATACGCC
GACCGCAGCTAACCGCCCC->ACCGCAGCTAACCGCCCCA
GACCGCAGCTAACCTCAGA->ACCGCAGCTAACCTCAGAG
GACCGCAGCTAACGTCTCA->ACCGCAGCTAACGTCTCAG
GACCGGAACGCTTATTGCC->ACCGGAACGCTTATTGCCT
GACCGTCATTCACACACAA->ACCGTCATTCACACACAAA
GACCTGGCCCAGGCCAGGA->ACCTGGCCCAGGCCAGGAG
GACCTTGAGTAATCAGGTG->ACCTTGAGTAATCAGGTGG
GACGAAAAAAAATAGCAGA->ACGAAAAAAAATAGCAGAT
GACGACTCGGTAGGAAAAT->ACGACTCGGTAGGAAAATG
GACGAGGCGAACTTTCCCA->ACGAGGCGAACTTTCCCAG
GACGCAGATGAATGAGGGG->ACGCAGATGAATGAGGGGG
GACGCTTGGATGACCTTGA->ACGCTTGGATGACCTTGAG
GACTAATCTAAGCCTTAAG->ACTAATCTAAGCCTTAAGG
GACTAGCGCGCTGATAACG->ACTAGCGCGCTGATAACGA
GACTAGCGCGCTGCGCAAG->ACTAGCGCGCTGCGCAAGT
GACTAGCGCGCTGGCCCCG->ACTAGCGCGCTGGCCCCGC
GACTAGCGCGCTGTATGCG->ACTAGCGCGCTGTATGCGT
GACTAGGCCATAGCTCCGG->ACTAGGCCATAGCTCCGGG
GACTCAGTGCCGTCTTCTT->ACTCAGTGCCGTCTTCTTG
GACTCGCAGTGGGCCCAGC->ACTCGCAGTGGGCCCAGCG
GACTCGGTAGGAAAATGCA->ACTCGGTAGGAAAATGCAT
GACTGATTCTGGTTAGGCG->ACTGATTCTGGTTAGGCGG
GACTGATTTAGCCACCTGT->ACTGATTTAGCCACCTGTC
GACTTTGCCCGTCTGCTAA->ACTTTGCCCGTCTGCTAAC
GAGAAAATTTCCCAGGGTC->AGAAAATTTCCCAGGGTCT
GAGAACCTGACAGCTGTTC->AGAACCTGACAGCTGTTCT
GAGAATCAGTGAGAAAATT->AGAATCAGTGAGAAAATTT
GAGACTAGCGCGCTGATAA->AGACTAGCGCGCTGATAAC
GAGACTAGCGCGCTGCGCA->AGACTAGCGCGCTGCGCAA
GAGACTAGCGCGCTGGCCC->AGACTAGCGCGCTGGCCCC
GAGACTAGCGCGCTGTATG->AGACTAGCGCGCTGTATGC
GAGACTAGGCCATAGCTCC->AGACTAGGCCATAGCTCCG
GAGAGACTAGCGCGCTGAT->AGAGACTAGCGCGCTGATA
GAGAGACTAGCGCGCTGCG->AGAGACTAGCGCGCTGCGC
GAGAGACTAGCGCGCTGGC->AGAGACTAGCGCGCTGGCC
GAGAGACTAGCGCGCTGTA->AGAGACTAGCGCGCTGTAT
GAGAGATCTGTCCGAATTA->AGAGATCTGTCCGAATTAA
GAGAGGCATGACAAATGGT->AGAGGCATGACAAATGGTC
GAGATCTGTCCGAATTAAC->AGATCTGTCCGAATTAACT
GAGATGGTTCAAATGCGAG->AGATGGTTCAAATGCGAGG
GAGATTACCGCGATGGTAA->AGATTACCGCGATGGTAAC
GAGCACTTCTCTGCACATA->AGCACTTCTCTGCACATAA
GAGCATCCAACCACAGTGT->AGCATCCAACCACAGTGTG
GAGCCAGTCCACTGATCCA->AGCCAGTCCACTGATCCAA
GAGCCCTTAGATCAGCTGG->AGCCCTTAGATCAGCTGGG
GAGCCTCGTCCAAAATTTC->AGCCTCGTCCAAAATTTCG
GAGCGAAGAGGCTCTCATT->AGCGAAGAGGCTCTCATTA
GAGGCATGACAAATGGTCA->AGGCATGACAAATGGTCAA
GAGGCCTATAGGGAGAGAC->AGGCCTATAGGGAGAGACT
GAGGCGAACTTTCCCAGGG->AGGCGAACTTTCCCAGGGC
GAGGCTCTCATTAATTATC->AGGCTCTCATTAATTATCA
GAGGGAAAGTAACGGGGAA->AGGGAAAGTAACGGGGAAG
GAGGGAGGGCTGTCGTTAT->AGGGAGGGCTGTCGTTATT
GAGGGCTGTCGTTATTCTG->AGGGCTGTCGTTATTCTGT
GAGGGGCCCATCCTAATCT->AGGGGCCCATCCTAATCTT
GAGGGGCGCGTGCGATAAA->AGGGGCGCGTGCGATAAAA
GAGGGGGGACTTTGCCCGT->AGGGGGGACTTTGCCCGTC
GAGGTAGCATTCAGCAGCA->AGGTAGCATTCAGCAGCAA
GAGGTCCTTGGCCCCTCCA->AGGTCCTTGGCCCCTCCAT
GAGTAATCAGGTGGTTCAG->AGTAATCAGGTGGTTCAGC
GAGTACTTGACATTTGTTG->AGTACTTGACATTTGTTGT
GAGTAGACGACTCGGTAGG->AGTAGACGACTCGGTAGGA
GAGTATCAGGTCCTCACGC->AGTATCAGGTCCTCACGCC
GAGTCCAGGGCGCCAACAA->AGTCCAGGGCGCCAACAAC
GAGTCGGTACCCCGTCTCA->AGTCGGTACCCCGTCTCAT
GAGTTTGCAACTAGCGTCA->AGTTTGCAACTAGCGTCAG
GAGTTTGCTAGGCGCGTAG->AGTTTGCTAGGCGCGTAGG
GATAAAAGGGAACTCTAGC->ATAAAAGGGAACTCTAGCT
GATAACGACAGGAATCACG->ATAACGACAGGAATCACGA
GATAAGGGGCGACCTGGCC->ATAAGGGGCGACCTGGCCC
GATAAGTATGCGCCTCACA->ATAAGTATGCGCCTCACAA
GATACTAGACTCAGTGCCG->ATACTAGACTCAGTGCCGT
GATAGATGCGGACACCGGC->ATAGATGCGGACACCGGCA
GATAGCGTTGCTAGTGTCA->ATAGCGTTGCTAGTGTCAA
GATAGGGAACAACCAATAA->ATAGGGAACAACCAATAAT
GATCAGCTGGGCTTGAGCA->ATCAGCTGGGCTTGAGCAC
GATCCAATCTCGTTCACAA->ATCCAATCTCGTTCACAAA
GATCCAGGCCATCCGAATG->ATCCAGGCCATCCGAATGC
GATCGCGATGCGCTCCCCG->ATCGCGATGCGCTCCCCGT
GATCTGTCCGAATTAACTT->ATCTGTCCGAATTAACTTC
GATGAACGAACCCTTTTGG->ATGAACGAACCCTTTTGGT
GATGAATGAGGGGGGACTT->ATGAATGAGGGGGGACTTT
GATGACCTTGAGTAATCAG->ATGACCTTGAGTAATCAGG
GATGATAGGGAACAACCAA->ATGATAGGGAACAACCAAT
GATGCGCTCCCCGTATCCA->ATGCGCTCCCCGTATCCAC
GATGCGGACACCGGCACGT->ATGCGGACACCGGCACGTC
GATGGTAACGCGGAACTCG->ATGGTAACGCGGAACTCGC
GATGGTTCAAATGCGAGGG->ATGGTTCAAATGCGAGGGA
GATGGTTCGGCAGGATGAA->ATGGTTCGGCAGGATGAAC
GATGTACGTTCTTACTCGC->ATGTACGTTCTTACTCGCC
GATGTGAGTCCAGGGCGCC->ATGTGAGTCCAGGGCGCCA
GATTACAATATGCGAAAAA->ATTACAATATGCGAAAAAG
GATTACCGCGATGGTAACG->ATTACCGCGATGGTAACGC
GATTCACCTATGGGTTTTG->ATTCACCTATGGGTTTTGT
GATTCTGGTTAGGCGGAGA->ATTCTGGTTAGGCGGAGAG
GATTGATTCACCTATGGGT->ATTGATTCACCTATGGGTT
GATTTAGCCACCTGTCGCT->ATTTAGCCACCTGTCGCTG
GCAAAACATAATGTGGTAT->CAAAACATAATGTGGTATA
GCAAACGGCAACTCCCCTC->CAAACGGCAACTCCCCTCT
GCAAATTATAGAGCCTCGT->CAAATTATAGAGCCTCGTC
GCAACTAGCGTCAGGCGGC->CAACTAGCGTCAGGCGGCA
GCAACTCCCCTCTCTATTT->CAACTCCCCTCTCTATTTT
GCAACTGTATTTAGGTGCT->CAACTGTATTTAGGTGCTC
GCAAGCACCACCGTTATTT->CAAGCACCACCGTTATTTC
GCAAGTGCTCAATCACGAC->CAAGTGCTCAATCACGACC
GCACATAACACGTTAAGGT->CACATAACACGTTAAGGTT
GCACCAAATCACGACCGCA->CACCAAATCACGACCGCAG
GCACCACCGTTATTTCCAG->CACCACCGTTATTTCCAGA
GCACGACATCGGCCGGATG->CACGACATCGGCCGGATGT
GCACGTCGATTGATTCACC->CACGTCGATTGATTCACCT
GCACGTCGCCCTGACACTA->CACGTCGCCCTGACACTAA
GCACTTCTCTGCACATAAC->CACTTCTCTGCACATAACA
GCAGATAAGTATGCGCCTC->CAGATAAGTATGCGCCTCA
GCAGATGAATGAGGGGGGA->CAGATGAATGAGGGGGGAC
GCAGCAAGCACCACCGTTA->CAGCAAGCACCACCGTTAT
GCAGCCATGGAATGGCAGT->CAGCCATGGAATGGCAGTA
GCAGCGCTGGTGGAGAGAC->CAGCGCTGGTGGAGAGACT
GCAGCTAACATACGCCATA->CAGCTAACATACGCCATAT
GCAGCTAACCGCCCCACTG->CAGCTAACCGCCCCACTGG
GCAGCTAACCTCAGAGTCG->CAGCTAACCTCAGAGTCGG
GCAGCTAACGTCTCAGTAG->CAGCTAACGTCTCAGTAGA
GCAGGATGAACGAACCCTT->CAGGATGAACGAACCCTTT
GCAGTAAGATAAGGGGCGA->CAGTAAGATAAGGGGCGAC
GCAGTGGGCCCAGCGGTAG->CAGTGGGCCCAGCGGTAGC
GCAGTTAAGATGTACGTTC->CAGTTAAGATGTACGTTCT
GCATAAGTCCCCCTCCCAT->CATAAGTCCCCCTCCCATT
GCATAGTCATGATGATAGG->CATAGTCATGATGATAGGG
GCATCCAACCACAGTGTGA->CATCCAACCACAGTGTGAC
GCATCTCCAAGGAGGTCCT->CATCTCCAAGGAGGTCCTT
GCATGACAAATGGTCAATT->CATGACAAATGGTCAATTA
GCATGAGATTACCGCGATG->CATGAGATTACCGCGATGG
GCATTCAGCAGCAAGCACC->CATTCAGCAGCAAGCACCA
GCATTTAGCCCCCCCGCCC->CATTTAGCCCCCCCGCCCC
GCCAACAACTGGTAAAGCC->CCAACAACTGGTAAAGCCC
GCCAAGTTTCACTACCGCT->CCAAGTTTCACTACCGCTC
GCCACCTGTCGCTGCTCGA->CCACCTGTCGCTGCTCGAA
GCCACGAGCATCCAACCAC->CCACGAGCATCCAACCACA
GCCACGCTTATATGGAGAG->CCACGCTTATATGGAGAGA
GCCACTGTCCATCATCAAA->CCACTGTCCATCATCAAAC
GCCAGGAGGCCTATAGGGA->CCAGGAGGCCTATAGGGAG
GCCAGTCCACTGATCCAAT->CCAGTCCACTGATCCAATC
GCCAGTGGGGGACTCGCAG->CCAGTGGGGGACTCGCAGT
GCCATAGCTCCGGGGGCCA->CCATAGCTCCGGGGGCCAC
GCCATATGGTCGCGAGTAC->CCATATGGTCGCGAGTACT
GCCATCCGAATGCACGACA->CCATCCGAATGCACGACAT
GCCATCGAAGGAATGGCCG->CCATCGAAGGAATGGCCGG
GCCATGGAATGGCAGTAAG->CCATGGAATGGCAGTAAGA
GCCCAGCGGTAGCCTAAAT->CCCAGCGGTAGCCTAAATA
GCCCAGGCCAGGAGGCCTA->CCCAGGCCAGGAGGCCTAT
GCCCATCCTAATCTTAGGT->CCCATCCTAATCTTAGGTG
GCCCCACTGGTGGCCAGTG->CCCCACTGGTGGCCAGTGG
GCCCCCCCGCCCCTACCAA->CCCCCCCGCCCCTACCAAA
GCCCCCTGTTGAGAACCTG->CCCCCTGTTGAGAACCTGA
GCCCCGCACCAAATCACGA->CCCCGCACCAAATCACGAC
GCCCCTACCAAACAGTAGG->CCCCTACCAAACAGTAGGA
GCCCCTCCATGCAAATTAT->CCCCTCCATGCAAATTATA
GCCCGAGGGGCGCGTGCGA->CCCGAGGGGCGCGTGCGAT
GCCCGTCTGCTAACGGGGC->CCCGTCTGCTAACGGGGCT
GCCCTGACACTAAGACCGG->CCCTGACACTAAGACCGGA
GCCCTTAGATCAGCTGGGC->CCCTTAGATCAGCTGGGCT
GCCGAGCCCTTAGATCAGC->CCGAGCCCTTAGATCAGCT
GCCGAGTATCAGGTCCTCA->CCGAGTATCAGGTCCTCAC
GCCGCATAAGTCCCCCTCC->CCGCATAAGTCCCCCTCCC
GCCGGATGTGAGTCCAGGG->CCGGATGTGAGTCCAGGGC
GCCGGGGAGGGGCCCATCC->CCGGGGAGGGGCCCATCCT
GCCGTAGTACTAAACTAAA->CCGTAGTACTAAACTAAAA
GCCGTCTTCTTGGAGATGG->CCGTCTTCTTGGAGATGGT
GCCTAAATACTATCGCCCG->CCTAAATACTATCGCCCGA
GCCTACCTCTGACGCTTGG->CCTACCTCTGACGCTTGGA
GCCTATAGGGAGAGACTAG->CCTATAGGGAGAGACTAGC
GCCTCACAAGCTCGTTGGA->CCTCACAAGCTCGTTGGAG
GCCTCACCCGGTTCGCAAA->CCTCACCCGGTTCGCAAAC
GCCTCGTCCAAAATTTCGA->CCTCGTCCAAAATTTCGAG
GCCTGATACTAGACTCAGT->CCTGATACTAGACTCAGTG
GCCTGCTGGAGCGAAGAGG->CCTGCTGGAGCGAAGAGGC
GCCTTAAGGCTGGCCGAGC->CCTTAAGGCTGGCCGAGCC
GCGAAAAAGGGCCACTGTC->CGAAAAAGGGCCACTGTCC
GCGAACGATTACAATATGC->CGAACGATTACAATATGCG
GCGAACTTTCCCAGGGCTC->CGAACTTTCCCAGGGCTCC
GCGAAGAGGCTCTCATTAA->CGAAGAGGCTCTCATTAAT
GCGACCTGGCCCAGGCCAG->CGACCTGGCCCAGGCCAGG
GCGAGGGAAAGTAACGGGG->CGAGGGAAAGTAACGGGGA
GCGAGGTAGCATTCAGCAG->CGAGGTAGCATTCAGCAGC
GCGAGTACTTGACATTTGT->CGAGTACTTGACATTTGTT
GCGATAAAAGGGAACTCTA->CGATAAAAGGGAACTCTAG
GCGATCGCGATGCGCTCCC->CGATCGCGATGCGCTCCCC
GCGATGCGCTCCCCGTATC->CGATGCGCTCCCCGTATCC
GCGATGGTAACGCGGAACT->CGATGGTAACGCGGAACTC
GCGCAAGTGCTCAATCACG->CGCAAGTGCTCAATCACGA
GCGCCAACAACTGGTAAAG->CGCCAACAACTGGTAAAGC
GCGCCTCACAAGCTCGTTG->CGCCTCACAAGCTCGTTGG
GCGCGCTGATAACGACAGG->CGCGCTGATAACGACAGGA
GCGCGCTGCGCAAGTGCTC->CGCGCTGCGCAAGTGCTCA
GCGCGCTGGCCCCGCACCA->CGCGCTGGCCCCGCACCAA
GCGCGCTGTATGCGTGGGT->CGCGCTGTATGCGTGGGTA
GCGCGTAGGGGACGAGGCG->CGCGTAGGGGACGAGGCGA
GCGCGTGCGATAAAAGGGA->CGCGTGCGATAAAAGGGAA
GCGCTCCCCGTATCCACAG->CGCTCCCCGTATCCACAGC
GCGCTGATAACGACAGGAA->CGCTGATAACGACAGGAAT
GCGCTGCGCAAGTGCTCAA->CGCTGCGCAAGTGCTCAAT
GCGCTGCTCAATCCGAACT->CGCTGCTCAATCCGAACTA
GCGCTGGCCCCGCACCAAA->CGCTGGCCCCGCACCAAAT
GCGCTGGTGGAGAGACTAG->CGCTGGTGGAGAGACTAGC
GCGCTGTATGCGTGGGTAA->CGCTGTATGCGTGGGTAAT
GCGGAACTCGCGAACGATT->CGGAACTCGCGAACGATTA
GCGGACACCGGCACGTCGC->CGGACACCGGCACGTCGCC
GCGGAGAGACTAGCGCGCT->CGGAGAGACTAGCGCGCTG
GCGGGCATCTCCAAGGAGG->CGGGCATCTCCAAGGAGGT
GCGGTAGCCTAAATACTAT->CGGTAGCCTAAATACTATC
GCGGTGGAACACGACAGCG->CGGTGGAACACGACAGCGG
GCGTAGGGGACGAGGCGAA->CGTAGGGGACGAGGCGAAC
GCGTCAGGCGGCACTAGCA->CGTCAGGCGGCACTAGCAA
GCGTCCACTGGTCGCCGAG->CGTCCACTGGTCGCCGAGT
GCGTGCGATAAAAGGGAAC->CGTGCGATAAAAGGGAACT
GCGTGGGTAATCACGACCG->CGTGGGTAATCACGACCGC
GCGTTGCTAGTGTCAACAG->CGTTGCTAGTGTCAACAGT
GCTAAATTTAGTTGGTAAC->CTAAATTTAGTTGGTAACG
GCTAACATACGCCATATGG->CTAACATACGCCATATGGT
GCTAACCGCCCCACTGGTG->CTAACCGCCCCACTGGTGG
GCTAACCTCAGAGTCGGTA->CTAACCTCAGAGTCGGTAC
GCTAACGGGGCTACATCTC->CTAACGGGGCTACATCTCC
GCTAACGTCTCAGTAGAGT->CTAACGTCTCAGTAGAGTT
GCTACATCTCCCAGCTATG->CTACATCTCCCAGCTATGA
GCTAGGCGCGTAGGGGACG->CTAGGCGCGTAGGGGACGA
GCTAGTGTCAACAGTCAGC->CTAGTGTCAACAGTCAGCA
GCTATGACTAATCTAAGCC->CTATGACTAATCTAAGCCT
GCTCAATCACGACCGCAGC->CTCAATCACGACCGCAGCT
GCTCAATCCGAACTAATGG->CTCAATCCGAACTAATGGC
GCTCATACATGGGTTTCCC->CTCATACATGGGTTTCCCG
GCTCCAGGAAGAGCCAGTC->CTCCAGGAAGAGCCAGTCC
GCTCCCCGTATCCACAGCC->CTCCCCGTATCCACAGCCA
GCTCCGGGGGCCACGCTTA->CTCCGGGGGCCACGCTTAT
GCTCCTGGGGCCTGCTGGA->CTCCTGGGGCCTGCTGGAG
GCTCCTGGTCCGAAACGGA->CTCCTGGTCCGAAACGGAA
GCTCGAAATTACTGTCAAC->CTCGAAATTACTGTCAACT
GCTCGTTGGAGTTTGCAAC->CTCGTTGGAGTTTGCAACT
GCTCTCATTAATTATCAAC->CTCTCATTAATTATCAACA
GCTGATAACGACAGGAATC->CTGATAACGACAGGAATCA
GCTGCGCAAGTGCTCAATC->CTGCGCAAGTGCTCAATCA
GCTGCTCAATCCGAACTAA->CTGCTCAATCCGAACTAAT
GCTGCTCGAAATTACTGTC->CTGCTCGAAATTACTGTCA
GCTGGAGCGAAGAGGCTCT->CTGGAGCGAAGAGGCTCTC
GCTGGCCCCGCACCAAATC->CTGGCCCCGCACCAAATCA
GCTGGCCGAGCCCTTAGAT->CTGGCCGAGCCCTTAGATC
GCTGGGCTTGAGCACTTCT->CTGGGCTTGAGCACTTCTC
GCTGGTGGAGAGACTAGCG->CTGGTGGAGAGACTAGCGC
GCTGTATGCGTGGGTAATC->CTGTATGCGTGGGTAATCA
GCTGTCGTTATTCTGTCAG->CTGTCGTTATTCTGTCAGC
GCTGTTCTGCGATCGCGAT->CTGTTCTGCGATCGCGATG
GCTTATATGGAGAGATCTG->CTTATATGGAGAGATCTGT
GCTTATTGCCTCACCCGGT->CTTATTGCCTCACCCGGTT
GCTTGAGCACTTCTCTGCA->CTTGAGCACTTCTCTGCAC
GCTTGATCCAGGCCATCCG->CTTGATCCAGGCCATCCGA
GCTTGGATGACCTTGAGTA->CTTGGATGACCTTGAGTAA
GGAAAATGCATGAGATTAC->GAAAATGCATGAGATTACC
GGAAAGTAACGGGGAAGGA->GAAAGTAACGGGGAAGGAG
GGAACAACCAATAATGTAT->GAACAACCAATAATGTATA
GGAACACGACAGCGGGCAT->GAACACGACAGCGGGCATC
GGAACGCTTATTGCCTCAC->GAACGCTTATTGCCTCACC
GGAACTCGCGAACGATTAC->GAACTCGCGAACGATTACA
GGAACTCTAGCTTGATCCA->GAACTCTAGCTTGATCCAG
GGAAGAGCCAGTCCACTGA->GAAGAGCCAGTCCACTGAT
GGAAGGAGAGACTAGCGCG->GAAGGAGAGACTAGCGCGC
GGAATCACGACCGCAGCTA->GAATCACGACCGCAGCTAA
GGAATCTGGACTGATTTAG->GAATCTGGACTGATTTAGC
GGAATGGCAGTAAGATAAG->GAATGGCAGTAAGATAAGG
GGAATGGCCGGGGAGGGGC->GAATGGCCGGGGAGGGGCC
GGAATGTTTGGTCATCTCG->GAATGTTTGGTCATCTCGC
GGACACCGGCACGTCGCCC->GACACCGGCACGTCGCCCT
GGACGAGGCGAACTTTCCC->GACGAGGCGAACTTTCCCA
GGACTCGCAGTGGGCCCAG->GACTCGCAGTGGGCCCAGC
GGACTGATTTAGCCACCTG->GACTGATTTAGCCACCTGT
GGACTTTGCCCGTCTGCTA->GACTTTGCCCGTCTGCTAA
GGAGAGACTAGCGCGCTGA->GAGAGACTAGCGCGCTGAT
GGAGAGACTAGCGCGCTGC->GAGAGACTAGCGCGCTGCG
GGAGAGACTAGCGCGCTGG->GAGAGACTAGCGCGCTGGC
GGAGAGACTAGCGCGCTGT->GAGAGACTAGCGCGCTGTA
GGAGAGATCTGTCCGAATT->GAGAGATCTGTCCGAATTA
GGAGATGGTTCAAATGCGA->GAGATGGTTCAAATGCGAG
GGAGCGAAGAGGCTCTCAT->GAGCGAAGAGGCTCTCATT
GGAGGCCTATAGGGAGAGA->GAGGCCTATAGGGAGAGAC
GGAGGGCTGTCGTTATTCT->GAGGGCTGTCGTTATTCTG
GGAGGGGCCCATCCTAATC->GAGGGGCCCATCCTAATCT
GGAGGTCCTTGGCCCCTCC->GAGGTCCTTGGCCCCTCCA
GGAGTAGACGACTCGGTAG->GAGTAGACGACTCGGTAGG
GGAGTTTGCAACTAGCGTC->GAGTTTGCAACTAGCGTCA
GGATAGATGCGGACACCGG->GATAGATGCGGACACCGGC
GGATGAACGAACCCTTTTG->GATGAACGAACCCTTTTGG
GGATGACCTTGAGTAATCA->GATGACCTTGAGTAATCAG
GGATGTGAGTCCAGGGCGC->GATGTGAGTCCAGGGCGCC
GGCAACTCCCCTCTCTATT->GCAACTCCCCTCTCTATTT
GGCACGTCGCCCTGACACT->GCACGTCGCCCTGACACTA
GGCAGGATGAACGAACCCT->GCAGGATGAACGAACCCTT
GGCAGTAAGATAAGGGGCG->GCAGTAAGATAAGGGGCGA
GGCATAGTCATGATGATAG->GCATAGTCATGATGATAGG
GGCATCTCCAAGGAGGTCC->GCATCTCCAAGGAGGTCCT
GGCATGACAAATGGTCAAT->GCATGACAAATGGTCAATT
GGCATTTAGCCCCCCCGCC->GCATTTAGCCCCCCCGCCC
GGCCACGCTTATATGGAGA->GCCACGCTTATATGGAGAG
GGCCACTGTCCATCATCAA->GCCACTGTCCATCATCAAA
GGCCAGGAGGCCTATAGGG->GCCAGGAGGCCTATAGGGA
GGCCAGTGGGGGACTCGCA->GCCAGTGGGGGACTCGCAG
GGCCATAGCTCCGGGGGCC->GCCATAGCTCCGGGGGCCA
GGCCATCCGAATGCACGAC->GCCATCCGAATGCACGACA
GGCCCAGCGGTAGCCTAAA->GCCCAGCGGTAGCCTAAAT
GGCCCAGGCCAGGAGGCCT->GCCCAGGCCAGGAGGCCTA
GGCCCATCCTAATCTTAGG->GCCCATCCTAATCTTAGGT
GGCCCCGCACCAAATCACG->GCCCCGCACCAAATCACGA
GGCCCCTCCATGCAAATTA->GCCCCTCCATGCAAATTAT
GGCCGAGCCCTTAGATCAG->GCCGAGCCCTTAGATCAGC
GGCCGGATGTGAGTCCAGG->GCCGGATGTGAGTCCAGGG
GGCCGGGGAGGGGCCCATC->GCCGGGGAGGGGCCCATCC
GGCCTATAGGGAGAGACTA->GCCTATAGGGAGAGACTAG
GGCCTGCTGGAGCGAAGAG->GCCTGCTGGAGCGAAGAGG
GGCGAACTTTCCCAGGGCT->GCGAACTTTCCCAGGGCTC
GGCGACCTGGCCCAGGCCA->GCGACCTGGCCCAGGCCAG
GGCGCCAACAACTGGTAAA->GCGCCAACAACTGGTAAAG
GGCGCGTAGGGGACGAGGC->GCGCGTAGGGGACGAGGCG
GGCGCGTGCGATAAAAGGG->GCGCGTGCGATAAAAGGGA
GGCGGAGAGACTAGCGCGC->GCGGAGAGACTAGCGCGCT
GGCGTCCACTGGTCGCCGA->GCGTCCACTGGTCGCCGAG
GGCTACATCTCCCAGCTAT->GCTACATCTCCCAGCTATG
GGCTCCAGGAAGAGCCAGT->GCTCCAGGAAGAGCCAGTC
GGCTCTCATTAATTATCAA->GCTCTCATTAATTATCAAC
GGCTGGCCGAGCCCTTAGA->GCTGGCCGAGCCCTTAGAT
GGCTGTCGTTATTCTGTCA->GCTGTCGTTATTCTGTCAG
GGCTTGAGCACTTCTCTGC->GCTTGAGCACTTCTCTGCA
GGGAAAGTAACGGGGAAGG->GGAAAGTAACGGGGAAGGA
GGGAACAACCAATAATGTA->GGAACAACCAATAATGTAT
GGGAACTCTAGCTTGATCC->GGAACTCTAGCTTGATCCA
GGGAAGGAGAGACTAGCGC->GGAAGGAGAGACTAGCGCG
GGGACGAGGCGAACTTTCC->GGACGAGGCGAACTTTCCC
GGGACTCGCAGTGGGCCCA->GGACTCGCAGTGGGCCCAG
GGGACTTTGCCCGTCTGCT->GGACTTTGCCCGTCTGCTA
GGGAGAGACTAGCGCGCTG->GGAGAGACTAGCGCGCTGG
GGGAGGGCTGTCGTTATTC->GGAGGGCTGTCGTTATTCT
GGGAGGGGCCCATCCTAAT->GGAGGGGCCCATCCTAATC
GGGAGTAGACGACTCGGTA->GGAGTAGACGACTCGGTAG
GGGCATCTCCAAGGAGGTC->GGCATCTCCAAGGAGGTCC
GGGCCACGCTTATATGGAG->GGCCACGCTTATATGGAGA
GGGCCACTGTCCATCATCA->GGCCACTGTCCATCATCAA
GGGCCCAGCGGTAGCCTAA->GGCCCAGCGGTAGCCTAAA
GGGCCCATCCTAATCTTAG->GGCCCATCCTAATCTTAGG
GGGCCTGCTGGAGCGAAGA->GGCCTGCTGGAGCGAAGAG
GGGCGACCTGGCCCAGGCC->GGCGACCTGGCCCAGGCCA
GGGCGCCAACAACTGGTAA->GGCGCCAACAACTGGTAAA
GGGCGCGTGCGATAAAAGG->GGCGCGTGCGATAAAAGGG
GGGCTACATCTCCCAGCTA->GGCTACATCTCCCAGCTAT
GGGCTCCAGGAAGAGCCAG->GGCTCCAGGAAGAGCCAGT
GGGCTGTCGTTATTCTGTC->GGCTGTCGTTATTCTGTCA
GGGCTTGAGCACTTCTCTG->GGCTTGAGCACTTCTCTGC
GGGGAAGGAGAGACTAGCG->GGGAAGGAGAGACTAGCGC
GGGGACGAGGCGAACTTTC->GGGACGAGGCGAACTTTCC
GGGGACTCGCAGTGGGCCC->GGGACTCGCAGTGGGCCCA
GGGGACTTTGCCCGTCTGC->GGGACTTTGCCCGTCTGCT
GGGGAGGGGCCCATCCTAA->GGGAGGGGCCCATCCTAAT
GGGGCCACGCTTATATGGA->GGGCCACGCTTATATGGAG
GGGGCCCATCCTAATCTTA->GGGCCCATCCTAATCTTAG
GGGGCCTGCTGGAGCGAAG->GGGCCTGCTGGAGCGAAGA
GGGGCGACCTGGCCCAGGC->GGGCGACCTGGCCCAGGCC
GGGGCGCGTGCGATAAAAG->GGGCGCGTGCGATAAAAGG
GGGGCTACATCTCCCAGCT->GGGCTACATCTCCCAGCTA
GGGGGACTCGCAGTGGGCC->GGGGACTCGCAGTGGGCCC
GGGGGACTTTGCCCGTCTG->GGGGACTTTGCCCGTCTGC
GGGGGCCACGCTTATATGG->GGGGCCACGCTTATATGGA
GGGGGGACTTTGCCCGTCT->GGGGGACTTTGCCCGTCTG
GGGTAATCACGACCGCAGC->GGTAATCACGACCGCAGCT
GGGTCTTATACATTGTCTG->GGTCTTATACATTGTCTGC
GGGTTTCCCGCTCCTGGGG->GGTTTCCCGCTCCTGGGGC
GGGTTTTGTGAATCGCAGT->GGTTTTGTGAATCGCAGTT
GGTAAAGCCCCCTGTTGAG->GTAAAGCCCCCTGTTGAGA
GGTAACGCGGAACTCGCGA->GTAACGCGGAACTCGCGAA
GGTAACGTATCGCCTGATA->GTAACGTATCGCCTGATAC
GGTAATCACGACCGCAGCT->GTAATCACGACCGCAGCTA
GGTACCCCGTCTCATCCTT->GTACCCCGTCTCATCCTTG
GGTACTGTTCTGGCGTCCA->GTACTGTTCTGGCGTCCAC
GGTAGCATTCAGCAGCAAG->GTAGCATTCAGCAGCAAGC
GGTAGCCTAAATACTATCG->GTAGCCTAAATACTATCGC
GGTAGGAAAATGCATGAGA->GTAGGAAAATGCATGAGAT
GGTATACACCCTAGTGTAT->GTATACACCCTAGTGTATT
GGTCAATTAATCTCGGGAG->GTCAATTAATCTCGGGAGT
GGTCATCTCGCAACTGTAT->GTCATCTCGCAACTGTATT
GGTCCGAAACGGAATCTGG->GTCCGAAACGGAATCTGGA
GGTCCTCACGCCGCATAAG->GTCCTCACGCCGCATAAGT
GGTCCTTATGACCAGCCTA->GTCCTTATGACCAGCCTAC
GGTCCTTGGCCCCTCCATG->GTCCTTGGCCCCTCCATGC
GGTCGCCGAGTATCAGGTC->GTCGCCGAGTATCAGGTCC
GGTCGCGAGTACTTGACAT->GTCGCGAGTACTTGACATT
GGTCTTATACATTGTCTGC->GTCTTATACATTGTCTGCG
GGTGCAGCCATGGAATGGC->GTGCAGCCATGGAATGGCA
GGTGCTCCTGGTCCGAAAC->GTGCTCCTGGTCCGAAACG
GGTGGAACACGACAGCGGG->GTGGAACACGACAGCGGGC
GGTGGAGAGACTAGCGCGC->GTGGAGAGACTAGCGCGCT
GGTGGCCAGTGGGGGACTC->GTGGCCAGTGGGGGACTCG
GGTGGTTCAGCAGCGCTGG->GTGGTTCAGCAGCGCTGGT
GGTTAGGCGGAGAGACTAG->GTTAGGCGGAGAGACTAGC
GGTTCAAATGCGAGGGAAA->GTTCAAATGCGAGGGAAAG
GGTTCAGCAGCGCTGGTGG->GTTCAGCAGCGCTGGTGGA
GGTTCGCAAACGGCAACTC->GTTCGCAAACGGCAACTCC
GGTTCGGCAGGATGAACGA->GTTCGGCAGGATGAACGAA
GGTTGCCGTAGTACTAAAC->GTTGCCGTAGTACTAAACT
GGTTTCCCGCTCCTGGGGC->GTTTCCCGCTCCTGGGGCC
GGTTTGTGACTGATTCTGG->GTTTGTGACTGATTCTGGT
GGTTTTATAAATCATTCCA->GTTTTATAAATCATTCCAC
GGTTTTGTGAATCGCAGTT->GTTTTGTGAATCGCAGTTA
GTAAAGCCCCCTGTTGAGA->TAAAGCCCCCTGTTGAGAA
GTAACGCGGAACTCGCGAA->TAACGCGGAACTCGCGAAC
GTAACGGGGAAGGAGAGAC->TAACGGGGAAGGAGAGACT
GTAACGTATCGCCTGATAC->TAACGTATCGCCTGATACT
GTAAGATAAGGGGCGACCT->TAAGATAAGGGGCGACCTG
GTAATCACGACCGCAGCTA->TAATCACGACCGCAGCTAA
GTAATCAGGTGGTTCAGCA->TAATCAGGTGGTTCAGCAG
GTACCCCGTCTCATCCTTG->TACCCCGTCTCATCCTTGT
GTACGTTCTTACTCGCCAT->TACGTTCTTACTCGCCATC
GTACTAAACTAAAAGTCCA->TACTAAACTAAAAGTCCAA
GTACTGTTCTGGCGTCCAC->TACTGTTCTGGCGTCCACT
GTACTTGACATTTGTTGTT->TACTTGACATTTGTTGTTG
GTAGACGACTCGGTAGGAA->TAGACGACTCGGTAGGAAA
GTAGAGTTTGCTAGGCGCG->TAGAGTTTGCTAGGCGCGT
GTAGCATTCAGCAGCAAGC->TAGCATTCAGCAGCAAGCA
GTAGCCTAAATACTATCGC->TAGCCTAAATACTATCGCC
GTAGGAAAATGCATGAGAT->TAGGAAAATGCATGAGATT
GTAGGAATGTTTGGTCATC->TAGGAATGTTTGGTCATCT
GTAGGGGACGAGGCGAACT->TAGGGGACGAGGCGAACTT
GTAGTACTAAACTAAAAGT->TAGTACTAAACTAAAAGTC
GTATAAGAGACTAGGCCAT->TATAAGAGACTAGGCCATA
GTATACACCCTAGTGTATT->TATACACCCTAGTGTATTT
GTATCAGGTCCTCACGCCG->TATCAGGTCCTCACGCCGC
GTATCCACAGCCACGAGCA->TATCCACAGCCACGAGCAT
GTATCGCCTGATACTAGAC->TATCGCCTGATACTAGACT
GTATGCGCCTCACAAGCTC->TATGCGCCTCACAAGCTCG
GTATGCGTGGGTAATCACG->TATGCGTGGGTAATCACGA
GTATGCTAAATTTAGTTGG->TATGCTAAATTTAGTTGGT
GTATTCTCGATGGTTCGGC->TATTCTCGATGGTTCGGCA
GTATTTAGGTGCTCCTGGT->TATTTAGGTGCTCCTGGTC
GTATTTCATTGCGGTGGAA->TATTTCATTGCGGTGGAAC
GTATTTGAGAATCAGTGAG->TATTTGAGAATCAGTGAGA
GTCAACAGTCAGCAAAACA->TCAACAGTCAGCAAAACAT
GTCAACTGTATGCTAAATT->TCAACTGTATGCTAAATTT
GTCAATTAATCTCGGGAGT->TCAATTAATCTCGGGAGTA
GTCAGCAAAACATAATGTG->TCAGCAAAACATAATGTGG
GTCAGCACGTCGATTGATT->TCAGCACGTCGATTGATTC
GTCATCTCGCAACTGTATT->TCATCTCGCAACTGTATTT
GTCATGATGATAGGGAACA->TCATGATGATAGGGAACAA
GTCATTCACACACAAAGCC->TCATTCACACACAAAGCCA
GTCCAAAATTTCGAGAGGC->TCCAAAATTTCGAGAGGCA
GTCCAAGGTTTGTGACTGA->TCCAAGGTTTGTGACTGAT
GTCCACTGATCCAATCTCG->TCCACTGATCCAATCTCGT
GTCCACTGGTCGCCGAGTA->TCCACTGGTCGCCGAGTAT
GTCCAGGGCGCCAACAACT->TCCAGGGCGCCAACAACTG
GTCCATCATCAAACAGTGG->TCCATCATCAAACAGTGGA
GTCCCCCTCCCATTTAGGT->TCCCCCTCCCATTTAGGTT
GTCCGAAACGGAATCTGGA->TCCGAAACGGAATCTGGAC
GTCCGAATTAACTTCAGGT->TCCGAATTAACTTCAGGTA
GTCCTCACGCCGCATAAGT->TCCTCACGCCGCATAAGTC
GTCCTTATGACCAGCCTAC->TCCTTATGACCAGCCTACC
GTCCTTGGCCCCTCCATGC->TCCTTGGCCCCTCCATGCA
GTCGATTGATTCACCTATG->TCGATTGATTCACCTATGG
GTCGCCCTGACACTAAGAC->TCGCCCTGACACTAAGACC
GTCGCCGAGTATCAGGTCC->TCGCCGAGTATCAGGTCCT
GTCGCGAGTACTTGACATT->TCGCGAGTACTTGACATTT
GTCGCTGCTCGAAATTACT->TCGCTGCTCGAAATTACTG
GTCGGTACCCCGTCTCATC->TCGGTACCCCGTCTCATCC
GTCGTCTTTTGCGCTGCTC->TCGTCTTTTGCGCTGCTCA
GTCGTTATTCTGTCAGCAC->TCGTTATTCTGTCAGCACG
GTCTCAGTAGAGTTTGCTA->TCTCAGTAGAGTTTGCTAG
GTCTCATCCTTGTCGTCTT->TCTCATCCTTGTCGTCTTT
GTCTGCGAGGTAGCATTCA->TCTGCGAGGTAGCATTCAG
GTCTGCTAACGGGGCTACA->TCTGCTAACGGGGCTACAT
GTCTTATACATTGTCTGCG->TCTTATACATTGTCTGCGA
GTCTTCTTGGAGATGGTTC->TCTTCTTGGAGATGGTTCA
GTCTTTTGCGCTGCTCAAT->TCTTTTGCGCTGCTCAATC
GTGAATCGCAGTTAAGATG->TGAATCGCAGTTAAGATGT
GTGACGAAAAAAAATAGCA->TGACGAAAAAAAATAGCAG
GTGACTGATTCTGGTTAGG->TGACTGATTCTGGTTAGGC
GTGAGAAAATTTCCCAGGG->TGAGAAAATTTCCCAGGGT
GTGAGTCCAGGGCGCCAAC->TGAGTCCAGGGCGCCAACA
GTGCAGCCATGGAATGGCA->TGCAGCCATGGAATGGCAG
GTGCCGTCTTCTTGGAGAT->TGCCGTCTTCTTGGAGATG
GTGCGATAAAAGGGAACTC->TGCGATAAAAGGGAACTCT
GTGCTCAATCACGACCGCA->TGCTCAATCACGACCGCAG
GTGCTCCTGGTCCGAAACG->TGCTCCTGGTCCGAAACGG
GTGGAACACGACAGCGGGC->TGGAACACGACAGCGGGCA
GTGGAGAGACTAGCGCGCT->TGGAGAGACTAGCGCGCTG
GTGGATAGATGCGGACACC->TGGATAGATGCGGACACCG
GTGGCCAGTGGGGGACTCG->TGGCCAGTGGGGGACTCGC
GTGGGCCCAGCGGTAGCCT->TGGGCCCAGCGGTAGCCTA
GTGGGGGACTCGCAGTGGG->TGGGGGACTCGCAGTGGGC
GTGGGTAATCACGACCGCA->TGGGTAATCACGACCGCAG
GTGGTATACACCCTAGTGT->TGGTATACACCCTAGTGTA
GTGGTTCAGCAGCGCTGGT->TGGTTCAGCAGCGCTGGTG
GTGTATTTGAGAATCAGTG->TGTATTTGAGAATCAGTGA
GTGTCAACAGTCAGCAAAA->TGTCAACAGTCAGCAAAAC
GTGTGACGAAAAAAAATAG->TGTGACGAAAAAAAATAGC
GTTAAGATGTACGTTCTTA->TTAAGATGTACGTTCTTAC
GTTAAGGTTGCCGTAGTAC->TTAAGGTTGCCGTAGTACT
GTTAGGCGGAGAGACTAGC->TTAGGCGGAGAGACTAGCG
GTTATTCTGTCAGCACGTC->TTATTCTGTCAGCACGTCG
GTTATTTCCAGACGCAGAT->TTATTTCCAGACGCAGATG
GTTCAAATGCGAGGGAAAG->TTCAAATGCGAGGGAAAGT
GTTCACAAAGTATTTCATT->TTCACAAAGTATTTCATTG
GTTCAGCAGCGCTGGTGGA->TTCAGCAGCGCTGGTGGAG
GTTCGCAAACGGCAACTCC->TTCGCAAACGGCAACTCCC
GTTCGGCAGGATGAACGAA->TTCGGCAGGATGAACGAAC
GTTCTGCGATCGCGATGCG->TTCTGCGATCGCGATGCGC
GTTCTGGCGTCCACTGGTC->TTCTGGCGTCCACTGGTCG
GTTCTTACTCGCCATCGAA->TTCTTACTCGCCATCGAAG
GTTGAGAACCTGACAGCTG->TTGAGAACCTGACAGCTGT
GTTGCCGTAGTACTAAACT->TTGCCGTAGTACTAAACTA
GTTGCTAGTGTCAACAGTC->TTGCTAGTGTCAACAGTCA
GTTGGAGTTTGCAACTAGC->TTGGAGTTTGCAACTAGCG
GTTGGCATTTAGCCCCCCC->TTGGCATTTAGCCCCCCCG
GTTGGTAACGTATCGCCTG->TTGGTAACGTATCGCCTGA
GTTGTTGGCATTTAGCCCC->TTGTTGGCATTTAGCCCCC
GTTTCACTACCGCTCATAC->TTTCACTACCGCTCATACA
GTTTCCCGCTCCTGGGGCC->TTTCCCGCTCCTGGGGCCT
GTTTGCAACTAGCGTCAGG->TTTGCAACTAGCGTCAGGC
GTTTGCTAGGCGCGTAGGG->TTTGCTAGGCGCGTAGGGG
GTTTGGTCATCTCGCAACT->TTTGGTCATCTCGCAACTG
GTTTGTGACTGATTCTGGT->TTTGTGACTGATTCTGGTT
GTTTTATAAATCATTCCAC->TTTTATAAATCATTCCACC
GTTTTGTGAATCGCAGTTA->TTTTGTGAATCGCAGTTAA
TAAAAGGGAACTCTAGCTT->AAAAGGGAACTCTAGCTTG
TAAAAGTCCAAGGTTTGTG->AAAAGTCCAAGGTTTGTGA
TAAACTAAAAGTCCAAGGT->AAACTAAAAGTCCAAGGTT
TAAAGCCCCCTGTTGAGAA->AAAGCCCCCTGTTGAGAAC
TAAATACTATCGCCCGAGG->AAATACTATCGCCCGAGGG
TAAATCATTCCACCGATAG->AAATCATTCCACCGATAGC
TAAATTTAGTTGGTAACGT->AAATTTAGTTGGTAACGTA
TAACACGTTAAGGTTGCCG->AACACGTTAAGGTTGCCGT
TAACATACGCCATATGGTC->AACATACGCCATATGGTCG
TAACCGCCCCACTGGTGGC->AACCGCCCCACTGGTGGCC
TAACCTCAGAGTCGGTACC->AACCTCAGAGTCGGTACCC
TAACGACAGGAATCACGAC->AACGACAGGAATCACGACC
TAACGCGGAACTCGCGAAC->AACGCGGAACTCGCGAACG
TAACGGGGAAGGAGAGACT->AACGGGGAAGGAGAGACTA
TAACGGGGCTACATCTCCC->AACGGGGCTACATCTCCCA
TAACGTATCGCCTGATACT->AACGTATCGCCTGATACTA
TAACGTCTCAGTAGAGTTT->AACGTCTCAGTAGAGTTTG
TAACTTCAGGTACTGTTCT->AACTTCAGGTACTGTTCTG
TAAGACCGGAACGCTTATT->AAGACCGGAACGCTTATTG
TAAGAGACTAGGCCATAGC->AAGAGACTAGGCCATAGCT
TAAGATAAGGGGCGACCTG->AAGATAAGGGGCGACCTGG
TAAGATGTACGTTCTTACT->AAGATGTACGTTCTTACTC
TAAGCCTTAAGGCTGGCCG->AAGCCTTAAGGCTGGCCGA
TAAGGCTGGCCGAGCCCTT->AAGGCTGGCCGAGCCCTTA
TAAGGGGCGACCTGGCCCA->AAGGGGCGACCTGGCCCAG
TAAGGTTGCCGTAGTACTA->AAGGTTGCCGTAGTACTAA
TAAGTATGCGCCTCACAAG->AAGTATGCGCCTCACAAGC
TAAGTCCCCCTCCCATTTA->AAGTCCCCCTCCCATTTAG
TAATCACGACCGCAGCTAA->AATCACGACCGCAGCTAAC
TAATCAGGTGGTTCAGCAG->AATCAGGTGGTTCAGCAGC
TAATCTAAGCCTTAAGGCT->AATCTAAGCCTTAAGGCTG
TAATCTCGGGAGTAGACGA->AATCTCGGGAGTAGACGAC
TAATCTTAGGTGCAGCCAT->AATCTTAGGTGCAGCCATG
TAATGGCATAGTCATGATG->AATGGCATAGTCATGATGA
TAATGTATAAGAGACTAGG->AATGTATAAGAGACTAGGC
TAATGTGGTATACACCCTA->AATGTGGTATACACCCTAG
TAATTATCAACACTGTATT->AATTATCAACACTGTATTC
TACAATATGCGAAAAAGGG->ACAATATGCGAAAAAGGGC
TACACCCTAGTGTATTTGA->ACACCCTAGTGTATTTGAG
TACATCTCCCAGCTATGAC->ACATCTCCCAGCTATGACT
TACATGGGTTTCCCGCTCC->ACATGGGTTTCCCGCTCCT
TACATTGTCTGCGAGGTAG->ACATTGTCTGCGAGGTAGC
TACCAAACAGTAGGAATGT->ACCAAACAGTAGGAATGTT
TACCCCGTCTCATCCTTGT->ACCCCGTCTCATCCTTGTC
TACCGCGATGGTAACGCGG->ACCGCGATGGTAACGCGGA
TACCGCTCATACATGGGTT->ACCGCTCATACATGGGTTT
TACCTCTGACGCTTGGATG->ACCTCTGACGCTTGGATGA
TACGCCATATGGTCGCGAG->ACGCCATATGGTCGCGAGT
TACGTTCTTACTCGCCATC->ACGTTCTTACTCGCCATCG
TACTAAACTAAAAGTCCAA->ACTAAACTAAAAGTCCAAG
TACTAGACTCAGTGCCGTC->ACTAGACTCAGTGCCGTCT
TACTATCGCCCGAGGGGCG->ACTATCGCCCGAGGGGCGC
TACTCGCCATCGAAGGAAT->ACTCGCCATCGAAGGAATG
TACTGTCAACTGTATGCTA->ACTGTCAACTGTATGCTAA
TACTGTTCTGGCGTCCACT->ACTGTTCTGGCGTCCACTG
TACTTGACATTTGTTGTTG->ACTTGACATTTGTTGTTGG
TAGACGACTCGGTAGGAAA->AGACGACTCGGTAGGAAAA
TAGACTCAGTGCCGTCTTC->AGACTCAGTGCCGTCTTCT
TAGAGCCTCGTCCAAAATT->AGAGCCTCGTCCAAAATTT
TAGAGGGAGGGCTGTCGTT->AGAGGGAGGGCTGTCGTTA
TAGAGTTTGCTAGGCGCGT->AGAGTTTGCTAGGCGCGTA
TAGATCAGCTGGGCTTGAG->AGATCAGCTGGGCTTGAGC
TAGATGCGGACACCGGCAC->AGATGCGGACACCGGCACG
TAGCAGATAAGTATGCGCC->AGCAGATAAGTATGCGCCT
TAGCATTCAGCAGCAAGCA->AGCATTCAGCAGCAAGCAC
TAGCCACCTGTCGCTGCTC->AGCCACCTGTCGCTGCTCG
TAGCCCCCCCGCCCCTACC->AGCCCCCCCGCCCCTACCA
TAGCCTAAATACTATCGCC->AGCCTAAATACTATCGCCC
TAGCGCGCTGATAACGACA->AGCGCGCTGATAACGACAG
TAGCGCGCTGCGCAAGTGC->AGCGCGCTGCGCAAGTGCT
TAGCGCGCTGGCCCCGCAC->AGCGCGCTGGCCCCGCACC
TAGCGCGCTGTATGCGTGG->AGCGCGCTGTATGCGTGGG
TAGCGTCAGGCGGCACTAG->AGCGTCAGGCGGCACTAGC
TAGCGTTGCTAGTGTCAAC->AGCGTTGCTAGTGTCAACA
TAGCTCCGGGGGCCACGCT->AGCTCCGGGGGCCACGCTT
TAGCTTGATCCAGGCCATC->AGCTTGATCCAGGCCATCC
TAGGAAAATGCATGAGATT->AGGAAAATGCATGAGATTA
TAGGAATGTTTGGTCATCT->AGGAATGTTTGGTCATCTC
TAGGCCATAGCTCCGGGGG->AGGCCATAGCTCCGGGGGC
TAGGCGCGTAGGGGACGAG->AGGCGCGTAGGGGACGAGG
TAGGCGGAGAGACTAGCGC->AGGCGGAGAGACTAGCGCG
TAGGGAACAACCAATAATG->AGGGAACAACCAATAATGT
TAGGGAGAGACTAGCGCGC->AGGGAGAGACTAGCGCGCT
TAGGGGACGAGGCGAACTT->AGGGGACGAGGCGAACTTT
TAGGTGCAGCCATGGAATG->AGGTGCAGCCATGGAATGG
TAGGTGCTCCTGGTCCGAA->AGGTGCTCCTGGTCCGAAA
TAGGTTTTATAAATCATTC->AGGTTTTATAAATCATTCC
TAGTACTAAACTAAAAGTC->AGTACTAAACTAAAAGTCC
TAGTCATGATGATAGGGAA->AGTCATGATGATAGGGAAC
TAGTGTATTTGAGAATCAG->AGTGTATTTGAGAATCAGT
TAGTGTCAACAGTCAGCAA->AGTGTCAACAGTCAGCAAA
TAGTTGGTAACGTATCGCC->AGTTGGTAACGTATCGCCT
TATAAATCATTCCACCGAT->ATAAATCATTCCACCGATA
TATAAGAGACTAGGCCATA->ATAAGAGACTAGGCCATAG
TATACACCCTAGTGTATTT->ATACACCCTAGTGTATTTG
TATACATTGTCTGCGAGGT->ATACATTGTCTGCGAGGTA
TATAGAGCCTCGTCCAAAA->ATAGAGCCTCGTCCAAAAT
TATAGGGAGAGACTAGCGC->ATAGGGAGAGACTAGCGCG
TATATGGAGAGATCTGTCC->ATATGGAGAGATCTGTCCG
TATCAACACTGTATTCTCG->ATCAACACTGTATTCTCGA
TATCAGGTCCTCACGCCGC->ATCAGGTCCTCACGCCGCA
TATCCACAGCCACGAGCAT->ATCCACAGCCACGAGCATC
TATCGCCCGAGGGGCGCGT->ATCGCCCGAGGGGCGCGTG
TATCGCCTGATACTAGACT->ATCGCCTGATACTAGACTC
TATGACCAGCCTACCTCTG->ATGACCAGCCTACCTCTGA
TATGACTAATCTAAGCCTT->ATGACTAATCTAAGCCTTA
TATGCGAAAAAGGGCCACT->ATGCGAAAAAGGGCCACTG
TATGCGCCTCACAAGCTCG->ATGCGCCTCACAAGCTCGT
TATGCGTGGGTAATCACGA->ATGCGTGGGTAATCACGAC
TATGCTAAATTTAGTTGGT->ATGCTAAATTTAGTTGGTA
TATGGAGAGATCTGTCCGA->ATGGAGAGATCTGTCCGAA
TATGGGTTTTGTGAATCGC->ATGGGTTTTGTGAATCGCA
TATGGTCGCGAGTACTTGA->ATGGTCGCGAGTACTTGAC
TATTCTCGATGGTTCGGCA->ATTCTCGATGGTTCGGCAG
TATTCTGTCAGCACGTCGA->ATTCTGTCAGCACGTCGAT
TATTGCCTCACCCGGTTCG->ATTGCCTCACCCGGTTCGC
TATTTAGGTGCTCCTGGTC->ATTTAGGTGCTCCTGGTCC
TATTTCATTGCGGTGGAAC->ATTTCATTGCGGTGGAACA
TATTTCCAGACGCAGATGA->ATTTCCAGACGCAGATGAA
TATTTGAGAATCAGTGAGA->ATTTGAGAATCAGTGAGAA
TATTTTAGAGGGAGGGCTG->ATTTTAGAGGGAGGGCTGT
TCAAACAGTGGATAGATGC->CAAACAGTGGATAGATGCG
TCAAATGCGAGGGAAAGTA->CAAATGCGAGGGAAAGTAA
TCAACACTGTATTCTCGAT->CAACACTGTATTCTCGATG
TCAACAGTCAGCAAAACAT->CAACAGTCAGCAAAACATA
TCAACTGTATGCTAAATTT->CAACTGTATGCTAAATTTA
TCAATCACGACCGCAGCTA->CAATCACGACCGCAGCTAA
TCAATCCGAACTAATGGCA->CAATCCGAACTAATGGCAT
TCAATTAATCTCGGGAGTA->CAATTAATCTCGGGAGTAG
TCACAAAGTATTTCATTGC->CACAAAGTATTTCATTGCG
TCACAAGCTCGTTGGAGTT->CACAAGCTCGTTGGAGTTT
TCACACACAAAGCCAAGTT->CACACACAAAGCCAAGTTT
TCACCCGGTTCGCAAACGG->CACCCGGTTCGCAAACGGC
TCACCTATGGGTTTTGTGA->CACCTATGGGTTTTGTGAA
TCACGACCGCAGCTAACAT->CACGACCGCAGCTAACATA
TCACGACCGCAGCTAACCG->CACGACCGCAGCTAACCGC
TCACGACCGCAGCTAACCT->CACGACCGCAGCTAACCTC
TCACGACCGCAGCTAACGT->CACGACCGCAGCTAACGTC
TCACGCCGCATAAGTCCCC->CACGCCGCATAAGTCCCCC
TCACTACCGCTCATACATG->CACTACCGCTCATACATGG
TCAGAGTCGGTACCCCGTC->CAGAGTCGGTACCCCGTCT
TCAGCAAAACATAATGTGG->CAGCAAAACATAATGTGGT
TCAGCACGTCGATTGATTC->CAGCACGTCGATTGATTCA
TCAGCAGCAAGCACCACCG->CAGCAGCAAGCACCACCGT
TCAGCAGCGCTGGTGGAGA->CAGCAGCGCTGGTGGAGAG
TCAGCTGGGCTTGAGCACT->CAGCTGGGCTTGAGCACTT
TCAGGTACTGTTCTGGCGT->CAGGTACTGTTCTGGCGTC
TCAGGTCCTCACGCCGCAT->CAGGTCCTCACGCCGCATA
TCAGGTGGTTCAGCAGCGC->CAGGTGGTTCAGCAGCGCT
TCAGTAGAGTTTGCTAGGC->CAGTAGAGTTTGCTAGGCG
TCAGTGAGAAAATTTCCCA->CAGTGAGAAAATTTCCCAG
TCAGTGCCGTCTTCTTGGA->CAGTGCCGTCTTCTTGGAG
TCATACATGGGTTTCCCGC->CATACATGGGTTTCCCGCT
TCATCAAACAGTGGATAGA->CATCAAACAGTGGATAGAT
TCATCCTTGTCGTCTTTTG->CATCCTTGTCGTCTTTTGC
TCATCTCGCAACTGTATTT->CATCTCGCAACTGTATTTA
TCATGATGATAGGGAACAA->CATGATGATAGGGAACAAC
TCATTAATTATCAACACTG->CATTAATTATCAACACTGT
TCATTCACACACAAAGCCA->CATTCACACACAAAGCCAA
TCATTCCACCGATAGCGTT->CATTCCACCGATAGCGTTG
TCATTGCGGTGGAACACGA->CATTGCGGTGGAACACGAC
TCCAAAATTTCGAGAGGCA->CCAAAATTTCGAGAGGCAT
TCCAACCACAGTGTGACGA->CCAACCACAGTGTGACGAA
TCCAAGGAGGTCCTTGGCC->CCAAGGAGGTCCTTGGCCC
TCCAAGGTTTGTGACTGAT->CCAAGGTTTGTGACTGATT
TCCAATCTCGTTCACAAAG->CCAATCTCGTTCACAAAGT
TCCACAGCCACGAGCATCC->CCACAGCCACGAGCATCCA
TCCACCGATAGCGTTGCTA->CCACCGATAGCGTTGCTAG
TCCACTGATCCAATCTCGT->CCACTGATCCAATCTCGTT
TCCACTGGTCGCCGAGTAT->CCACTGGTCGCCGAGTATC
TCCAGACGCAGATGAATGA->CCAGACGCAGATGAATGAG
TCCAGGAAGAGCCAGTCCA->CCAGGAAGAGCCAGTCCAC
TCCAGGCCATCCGAATGCA->CCAGGCCATCCGAATGCAC
TCCAGGGCGCCAACAACTG->CCAGGGCGCCAACAACTGG
TCCATCATCAAACAGTGGA->CCATCATCAAACAGTGGAT
TCCATGCAAATTATAGAGC->CCATGCAAATTATAGAGCC
TCCCAGCTATGACTAATCT->CCCAGCTATGACTAATCTA
TCCCAGGGCTCCAGGAAGA->CCCAGGGCTCCAGGAAGAG
TCCCAGGGTCTTATACATT->CCCAGGGTCTTATACATTG
TCCCATTTAGGTTTTATAA->CCCATTTAGGTTTTATAAA
TCCCCCTCCCATTTAGGTT->CCCCCTCCCATTTAGGTTT
TCCCCGTATCCACAGCCAC->CCCCGTATCCACAGCCACG
TCCCCTCTCTATTTTAGAG->CCCCTCTCTATTTTAGAGG
TCCCGCTCCTGGGGCCTGC->CCCGCTCCTGGGGCCTGCT
TCCGAAACGGAATCTGGAC->CCGAAACGGAATCTGGACT
TCCGAACTAATGGCATAGT->CCGAACTAATGGCATAGTC
TCCGAATGCACGACATCGG->CCGAATGCACGACATCGGC
TCCGAATTAACTTCAGGTA->CCGAATTAACTTCAGGTAC
TCCGGGGGCCACGCTTATA->CCGGGGGCCACGCTTATAT
TCCTAATCTTAGGTGCAGC->CCTAATCTTAGGTGCAGCC
TCCTCACGCCGCATAAGTC->CCTCACGCCGCATAAGTCC
TCCTGGGGCCTGCTGGAGC->CCTGGGGCCTGCTGGAGCG
TCCTGGTCCGAAACGGAAT->CCTGGTCCGAAACGGAATC
TCCTTATGACCAGCCTACC->CCTTATGACCAGCCTACCT
TCCTTGGCCCCTCCATGCA->CCTTGGCCCCTCCATGCAA
TCCTTGTCGTCTTTTGCGC->CCTTGTCGTCTTTTGCGCT
TCGAAATTACTGTCAACTG->CGAAATTACTGTCAACTGT
TCGAAGGAATGGCCGGGGA->CGAAGGAATGGCCGGGGAG
TCGAGAGGCATGACAAATG->CGAGAGGCATGACAAATGG
TCGATGGTTCGGCAGGATG->CGATGGTTCGGCAGGATGA
TCGATTGATTCACCTATGG->CGATTGATTCACCTATGGG
TCGCAAACGGCAACTCCCC->CGCAAACGGCAACTCCCCT
TCGCAACTGTATTTAGGTG->CGCAACTGTATTTAGGTGC
TCGCAGTGGGCCCAGCGGT->CGCAGTGGGCCCAGCGGTA
TCGCAGTTAAGATGTACGT->CGCAGTTAAGATGTACGTT
TCGCCATCGAAGGAATGGC->CGCCATCGAAGGAATGGCC
TCGCCCGAGGGGCGCGTGC->CGCCCGAGGGGCGCGTGCG
TCGCCCTGACACTAAGACC->CGCCCTGACACTAAGACCG
TCGCCGAGTATCAGGTCCT->CGCCGAGTATCAGGTCCTC
TCGCCTGATACTAGACTCA->CGCCTGATACTAGACTCAG
TCGCGAACGATTACAATAT->CGCGAACGATTACAATATG
TCGCGAGTACTTGACATTT->CGCGAGTACTTGACATTTG
TCGCGATGCGCTCCCCGTA->CGCGATGCGCTCCCCGTAT
TCGCTGCTCGAAATTACTG->CGCTGCTCGAAATTACTGT
TCGGCAGGATGAACGAACC->CGGCAGGATGAACGAACCC
TCGGCCGGATGTGAGTCCA->CGGCCGGATGTGAGTCCAG
TCGGGAGTAGACGACTCGG->CGGGAGTAGACGACTCGGT
TCGGTACCCCGTCTCATCC->CGGTACCCCGTCTCATCCT
TCGGTAGGAAAATGCATGA->CGGTAGGAAAATGCATGAG
TCGTCCAAAATTTCGAGAG->CGTCCAAAATTTCGAGAGG
TCGTCTTTTGCGCTGCTCA->CGTCTTTTGCGCTGCTCAA
TCGTTATTCTGTCAGCACG->CGTTATTCTGTCAGCACGT
TCGTTCACAAAGTATTTCA->CGTTCACAAAGTATTTCAT
TCGTTGGAGTTTGCAACTA->CGTTGGAGTTTGCAACTAG
TCTAAGCCTTAAGGCTGGC->CTAAGCCTTAAGGCTGGCC
TCTAGCTTGATCCAGGCCA->CTAGCTTGATCCAGGCCAT
TCTATTTTAGAGGGAGGGC->CTATTTTAGAGGGAGGGCT
TCTCAGTAGAGTTTGCTAG->CTCAGTAGAGTTTGCTAGG
TCTCATCCTTGTCGTCTTT->CTCATCCTTGTCGTCTTTT
TCTCATTAATTATCAACAC->CTCATTAATTATCAACACT
TCTCCAAGGAGGTCCTTGG->CTCCAAGGAGGTCCTTGGC
TCTCCCAGCTATGACTAAT->CTCCCAGCTATGACTAATC
TCTCGATGGTTCGGCAGGA->CTCGATGGTTCGGCAGGAT
TCTCGCAACTGTATTTAGG->CTCGCAACTGTATTTAGGT
TCTCGGGAGTAGACGACTC->CTCGGGAGTAGACGACTCG
TCTCGTTCACAAAGTATTT->CTCGTTCACAAAGTATTTC
TCTCTATTTTAGAGGGAGG->CTCTATTTTAGAGGGAGGG
TCTCTGCACATAACACGTT->CTCTGCACATAACACGTTA
TCTGACGCTTGGATGACCT->CTGACGCTTGGATGACCTT
TCTGCACATAACACGTTAA->CTGCACATAACACGTTAAG
TCTGCGAGGTAGCATTCAG->CTGCGAGGTAGCATTCAGC
TCTGCGATCGCGATGCGCT->CTGCGATCGCGATGCGCTC
TCTGCTAACGGGGCTACAT->CTGCTAACGGGGCTACATC
TCTGGACTGATTTAGCCAC->CTGGACTGATTTAGCCACC
TCTGGCGTCCACTGGTCGC->CTGGCGTCCACTGGTCGCC
TCTGGTTAGGCGGAGAGAC->CTGGTTAGGCGGAGAGACT
TCTGTCAGCACGTCGATTG->CTGTCAGCACGTCGATTGA
TCTGTCCGAATTAACTTCA->CTGTCCGAATTAACTTCAG
TCTTACTCGCCATCGAAGG->CTTACTCGCCATCGAAGGA
TCTTAGGTGCAGCCATGGA->CTTAGGTGCAGCCATGGAA
TCTTATACATTGTCTGCGA->CTTATACATTGTCTGCGAG
TCTTCTTGGAGATGGTTCA->CTTCTTGGAGATGGTTCAA
TCTTGGAGATGGTTCAAAT->CTTGGAGATGGTTCAAATG
TCTTTTGCGCTGCTCAATC->CTTTTGCGCTGCTCAATCC
TGAACGAACCCTTTTGGTC->GAACGAACCCTTTTGGTCC
TGAATCGCAGTTAAGATGT->GAATCGCAGTTAAGATGTA
TGAATGAGGGGGGACTTTG->GAATGAGGGGGGACTTTGC
TGACAAATGGTCAATTAAT->GACAAATGGTCAATTAATC
TGACACTAAGACCGGAACG->GACACTAAGACCGGAACGC
TGACAGCTGTTCTGCGATC->GACAGCTGTTCTGCGATCG
TGACATTTGTTGTTGGCAT->GACATTTGTTGTTGGCATT
TGACCAGCCTACCTCTGAC->GACCAGCCTACCTCTGACG
TGACCGTCATTCACACACA->GACCGTCATTCACACACAA
TGACCTTGAGTAATCAGGT->GACCTTGAGTAATCAGGTG
TGACGAAAAAAAATAGCAG->GACGAAAAAAAATAGCAGA
TGACGCTTGGATGACCTTG->GACGCTTGGATGACCTTGA
TGACTAATCTAAGCCTTAA->GACTAATCTAAGCCTTAAG
TGACTGATTCTGGTTAGGC->GACTGATTCTGGTTAGGCG
TGAGAAAATTTCCCAGGGT->GAGAAAATTTCCCAGGGTC
TGAGAACCTGACAGCTGTT->GAGAACCTGACAGCTGTTC
TGAGAATCAGTGAGAAAAT->GAGAATCAGTGAGAAAATT
TGAGATTACCGCGATGGTA->GAGATTACCGCGATGGTAA
TGAGCACTTCTCTGCACAT->GAGCACTTCTCTGCACATA
TGAGGGGGGACTTTGCCCG->GAGGGGGGACTTTGCCCGT
TGAGTAATCAGGTGGTTCA->GAGTAATCAGGTGGTTCAG
TGAGTCCAGGGCGCCAACA->GAGTCCAGGGCGCCAACAA
TGATAACGACAGGAATCAC->GATAACGACAGGAATCACG
TGATACTAGACTCAGTGCC->GATACTAGACTCAGTGCCG
TGATAGGGAACAACCAATA->GATAGGGAACAACCAATAA
TGATCCAATCTCGTTCACA->GATCCAATCTCGTTCACAA
TGATCCAGGCCATCCGAAT->GATCCAGGCCATCCGAATG
TGATGATAGGGAACAACCA->GATGATAGGGAACAACCAA
TGATTCACCTATGGGTTTT->GATTCACCTATGGGTTTTG
TGATTCTGGTTAGGCGGAG->GATTCTGGTTAGGCGGAGA
TGATTTAGCCACCTGTCGC->GATTTAGCCACCTGTCGCT
TGCAAATTATAGAGCCTCG->GCAAATTATAGAGCCTCGT
TGCAACTAGCGTCAGGCGG->GCAACTAGCGTCAGGCGGC
TGCACATAACACGTTAAGG->GCACATAACACGTTAAGGT
TGCACGACATCGGCCGGAT->GCACGACATCGGCCGGATG
TGCAGCCATGGAATGGCAG->GCAGCCATGGAATGGCAGT
TGCATGAGATTACCGCGAT->GCATGAGATTACCGCGATG
TGCCCGTCTGCTAACGGGG->GCCCGTCTGCTAACGGGGC
TGCCGTAGTACTAAACTAA->GCCGTAGTACTAAACTAAA
TGCCGTCTTCTTGGAGATG->GCCGTCTTCTTGGAGATGG
TGCCTCACCCGGTTCGCAA->GCCTCACCCGGTTCGCAAA
TGCGAAAAAGGGCCACTGT->GCGAAAAAGGGCCACTGTC
TGCGAGGGAAAGTAACGGG->GCGAGGGAAAGTAACGGGG
TGCGAGGTAGCATTCAGCA->GCGAGGTAGCATTCAGCAG
TGCGATAAAAGGGAACTCT->GCGATAAAAGGGAACTCTA
TGCGATCGCGATGCGCTCC->GCGATCGCGATGCGCTCCC
TGCGCAAGTGCTCAATCAC->GCGCAAGTGCTCAATCACG
TGCGCCTCACAAGCTCGTT->GCGCCTCACAAGCTCGTTG
TGCGCTCCCCGTATCCACA->GCGCTCCCCGTATCCACAG
TGCGCTGCTCAATCCGAAC->GCGCTGCTCAATCCGAACT
TGCGGACACCGGCACGTCG->GCGGACACCGGCACGTCGC
TGCGGTGGAACACGACAGC->GCGGTGGAACACGACAGCG
TGCGTGGGTAATCACGACC->GCGTGGGTAATCACGACCG
TGCTAAATTTAGTTGGTAA->GCTAAATTTAGTTGGTAAC
TGCTAACGGGGCTACATCT->GCTAACGGGGCTACATCTC
TGCTAGGCGCGTAGGGGAC->GCTAGGCGCGTAGGGGACG
TGCTAGTGTCAACAGTCAG->GCTAGTGTCAACAGTCAGC
TGCTCAATCACGACCGCAG->GCTCAATCACGACCGCAGC
TGCTCAATCCGAACTAATG->GCTCAATCCGAACTAATGG
TGCTCCTGGTCCGAAACGG->GCTCCTGGTCCGAAACGGA
TGCTCGAAATTACTGTCAA->GCTCGAAATTACTGTCAAC
TGCTGGAGCGAAGAGGCTC->GCTGGAGCGAAGAGGCTCT
TGGAACACGACAGCGGGCA->GGAACACGACAGCGGGCAT
TGGAATGGCAGTAAGATAA->GGAATGGCAGTAAGATAAG
TGGACTGATTTAGCCACCT->GGACTGATTTAGCCACCTG
TGGAGAGACTAGCGCGCTG->GGAGAGACTAGCGCGCTGT
TGGAGAGATCTGTCCGAAT->GGAGAGATCTGTCCGAATT
TGGAGATGGTTCAAATGCG->GGAGATGGTTCAAATGCGA
TGGAGCGAAGAGGCTCTCA->GGAGCGAAGAGGCTCTCAT
TGGAGTTTGCAACTAGCGT->GGAGTTTGCAACTAGCGTC
TGGATAGATGCGGACACCG->GGATAGATGCGGACACCGG
TGGATGACCTTGAGTAATC->GGATGACCTTGAGTAATCA
TGGCAGTAAGATAAGGGGC->GGCAGTAAGATAAGGGGCG
TGGCATAGTCATGATGATA->GGCATAGTCATGATGATAG
TGGCATTTAGCCCCCCCGC->GGCATTTAGCCCCCCCGCC
TGGCCAGTGGGGGACTCGC->GGCCAGTGGGGGACTCGCA
TGGCCCAGGCCAGGAGGCC->GGCCCAGGCCAGGAGGCCT
TGGCCCCGCACCAAATCAC->GGCCCCGCACCAAATCACG
TGGCCCCTCCATGCAAATT->GGCCCCTCCATGCAAATTA
TGGCCGAGCCCTTAGATCA->GGCCGAGCCCTTAGATCAG
TGGCCGGGGAGGGGCCCAT->GGCCGGGGAGGGGCCCATC
TGGCGTCCACTGGTCGCCG->GGCGTCCACTGGTCGCCGA
TGGGCCCAGCGGTAGCCTA->GGGCCCAGCGGTAGCCTAA
TGGGCTTGAGCACTTCTCT->GGGCTTGAGCACTTCTCTG
TGGGGCCTGCTGGAGCGAA->GGGGCCTGCTGGAGCGAAG
TGGGGGACTCGCAGTGGGC->GGGGGACTCGCAGTGGGCC
TGGGTAATCACGACCGCAG->GGGTAATCACGACCGCAGC
TGGGTTTCCCGCTCCTGGG->GGGTTTCCCGCTCCTGGGG
TGGGTTTTGTGAATCGCAG->GGGTTTTGTGAATCGCAGT
TGGTAAAGCCCCCTGTTGA->GGTAAAGCCCCCTGTTGAG
TGGTAACGCGGAACTCGCG->GGTAACGCGGAACTCGCGA
TGGTAACGTATCGCCTGAT->GGTAACGTATCGCCTGATA
TGGTATACACCCTAGTGTA->GGTATACACCCTAGTGTAT
TGGTCAATTAATCTCGGGA->GGTCAATTAATCTCGGGAG
TGGTCATCTCGCAACTGTA->GGTCATCTCGCAACTGTAT
TGGTCCGAAACGGAATCTG->GGTCCGAAACGGAATCTGG
TGGTCCTTATGACCAGCCT->GGTCCTTATGACCAGCCTA
TGGTCGCCGAGTATCAGGT->GGTCGCCGAGTATCAGGTC
TGGTCGCGAGTACTTGACA->GGTCGCGAGTACTTGACAT
TGGTGGAGAGACTAGCGCG->GGTGGAGAGACTAGCGCGC
TGGTGGCCAGTGGGGGACT->GGTGGCCAGTGGGGGACTC
TGGTTAGGCGGAGAGACTA->GGTTAGGCGGAGAGACTAG
TGGTTCAAATGCGAGGGAA->GGTTCAAATGCGAGGGAAA
TGGTTCAGCAGCGCTGGTG->GGTTCAGCAGCGCTGGTGG
TGGTTCGGCAGGATGAACG->GGTTCGGCAGGATGAACGA
TGTACGTTCTTACTCGCCA->GTACGTTCTTACTCGCCAT
TGTATAAGAGACTAGGCCA->GTATAAGAGACTAGGCCAT
TGTATGCGTGGGTAATCAC->GTATGCGTGGGTAATCACG
TGTATGCTAAATTTAGTTG->GTATGCTAAATTTAGTTGG
TGTATTCTCGATGGTTCGG->GTATTCTCGATGGTTCGGC
TGTATTTAGGTGCTCCTGG->GTATTTAGGTGCTCCTGGT
TGTATTTGAGAATCAGTGA->GTATTTGAGAATCAGTGAG
TGTCAACAGTCAGCAAAAC->GTCAACAGTCAGCAAAACA
TGTCAACTGTATGCTAAAT->GTCAACTGTATGCTAAATT
TGTCAGCACGTCGATTGAT->GTCAGCACGTCGATTGATT
TGTCCATCATCAAACAGTG->GTCCATCATCAAACAGTGG
TGTCCGAATTAACTTCAGG->GTCCGAATTAACTTCAGGT
TGTCGCTGCTCGAAATTAC->GTCGCTGCTCGAAATTACT
TGTCGTCTTTTGCGCTGCT->GTCGTCTTTTGCGCTGCTC
TGTCGTTATTCTGTCAGCA->GTCGTTATTCTGTCAGCAC
TGTCTGCGAGGTAGCATTC->GTCTGCGAGGTAGCATTCA
TGTGAATCGCAGTTAAGAT->GTGAATCGCAGTTAAGATG
TGTGACGAAAAAAAATAGC->GTGACGAAAAAAAATAGCA
TGTGACTGATTCTGGTTAG->GTGACTGATTCTGGTTAGG
TGTGAGTCCAGGGCGCCAA->GTGAGTCCAGGGCGCCAAC
TGTGGTATACACCCTAGTG->GTGGTATACACCCTAGTGT
TGTTCTGCGATCGCGATGC->GTTCTGCGATCGCGATGCG
TGTTCTGGCGTCCACTGGT->GTTCTGGCGTCCACTGGTC
TGTTGAGAACCTGACAGCT->GTTGAGAACCTGACAGCTG
TGTTGGCATTTAGCCCCCC->GTTGGCATTTAGCCCCCCC
TGTTGTTGGCATTTAGCCC->GTTGTTGGCATTTAGCCCC
TGTTTGGTCATCTCGCAAC->GTTTGGTCATCTCGCAACT
TTAACTTCAGGTACTGTTC->TAACTTCAGGTACTGTTCT
TTAAGATGTACGTTCTTAC->TAAGATGTACGTTCTTACT
TTAAGGCTGGCCGAGCCCT->TAAGGCTGGCCGAGCCCTT
TTAAGGTTGCCGTAGTACT->TAAGGTTGCCGTAGTACTA
TTAATCTCGGGAGTAGACG->TAATCTCGGGAGTAGACGA
TTAATTATCAACACTGTAT->TAATTATCAACACTGTATT
TTACAATATGCGAAAAAGG->TACAATATGCGAAAAAGGG
TTACCGCGATGGTAACGCG->TACCGCGATGGTAACGCGG
TTACTCGCCATCGAAGGAA->TACTCGCCATCGAAGGAAT
TTACTGTCAACTGTATGCT->TACTGTCAACTGTATGCTA
TTAGAGGGAGGGCTGTCGT->TAGAGGGAGGGCTGTCGTT
TTAGATCAGCTGGGCTTGA->TAGATCAGCTGGGCTTGAG
TTAGCCACCTGTCGCTGCT->TAGCCACCTGTCGCTGCTC
TTAGCCCCCCCGCCCCTAC->TAGCCCCCCCGCCCCTACC
TTAGGCGGAGAGACTAGCG->TAGGCGGAGAGACTAGCGC
TTAGGTGCAGCCATGGAAT->TAGGTGCAGCCATGGAATG
TTAGGTGCTCCTGGTCCGA->TAGGTGCTCCTGGTCCGAA
TTAGGTTTTATAAATCATT->TAGGTTTTATAAATCATTC
TTAGTTGGTAACGTATCGC->TAGTTGGTAACGTATCGCC
TTATAAATCATTCCACCGA->TATAAATCATTCCACCGAT
TTATACATTGTCTGCGAGG->TATACATTGTCTGCGAGGT
TTATAGAGCCTCGTCCAAA->TATAGAGCCTCGTCCAAAA
TTATATGGAGAGATCTGTC->TATATGGAGAGATCTGTCC
TTATCAACACTGTATTCTC->TATCAACACTGTATTCTCG
TTATGACCAGCCTACCTCT->TATGACCAGCCTACCTCTG
TTATTCTGTCAGCACGTCG->TATTCTGTCAGCACGTCGA
TTATTGCCTCACCCGGTTC->TATTGCCTCACCCGGTTCG
TTATTTCCAGACGCAGATG->TATTTCCAGACGCAGATGA
TTCAAATGCGAGGGAAAGT->TCAAATGCGAGGGAAAGTA
TTCACAAAGTATTTCATTG->TCACAAAGTATTTCATTGC
TTCACACACAAAGCCAAGT->TCACACACAAAGCCAAGTT
TTCACCTATGGGTTTTGTG->TCACCTATGGGTTTTGTGA
TTCACTACCGCTCATACAT->TCACTACCGCTCATACATG
TTCAGCAGCAAGCACCACC->TCAGCAGCAAGCACCACCG
TTCAGCAGCGCTGGTGGAG->TCAGCAGCGCTGGTGGAGA
TTCAGGTACTGTTCTGGCG->TCAGGTACTGTTCTGGCGT
TTCATTGCGGTGGAACACG->TCATTGCGGTGGAACACGA
TTCCACCGATAGCGTTGCT->TCCACCGATAGCGTTGCTA
TTCCAGACGCAGATGAATG->TCCAGACGCAGATGAATGA
TTCCCAGGGCTCCAGGAAG->TCCCAGGGCTCCAGGAAGA
TTCCCAGGGTCTTATACAT->TCCCAGGGTCTTATACATT
TTCCCGCTCCTGGGGCCTG->TCCCGCTCCTGGGGCCTGC
TTCGAGAGGCATGACAAAT->TCGAGAGGCATGACAAATG
TTCGCAAACGGCAACTCCC->TCGCAAACGGCAACTCCCC
TTCGGCAGGATGAACGAAC->TCGGCAGGATGAACGAACC
TTCTCGATGGTTCGGCAGG->TCTCGATGGTTCGGCAGGA
TTCTCTGCACATAACACGT->TCTCTGCACATAACACGTT
TTCTGCGATCGCGATGCGC->TCTGCGATCGCGATGCGCT
TTCTGGCGTCCACTGGTCG->TCTGGCGTCCACTGGTCGC
TTCTGGTTAGGCGGAGAGA->TCTGGTTAGGCGGAGAGAC
TTCTGTCAGCACGTCGATT->TCTGTCAGCACGTCGATTG
TTCTTACTCGCCATCGAAG->TCTTACTCGCCATCGAAGG
TTCTTGGAGATGGTTCAAA->TCTTGGAGATGGTTCAAAT
TTGACATTTGTTGTTGGCA->TGACATTTGTTGTTGGCAT
TTGAGAACCTGACAGCTGT->TGAGAACCTGACAGCTGTT
TTGAGAATCAGTGAGAAAA->TGAGAATCAGTGAGAAAAT
TTGAGCACTTCTCTGCACA->TGAGCACTTCTCTGCACAT
TTGAGTAATCAGGTGGTTC->TGAGTAATCAGGTGGTTCA
TTGATCCAGGCCATCCGAA->TGATCCAGGCCATCCGAAT
TTGATTCACCTATGGGTTT->TGATTCACCTATGGGTTTT
TTGCAACTAGCGTCAGGCG->TGCAACTAGCGTCAGGCGG
TTGCCCGTCTGCTAACGGG->TGCCCGTCTGCTAACGGGG
TTGCCGTAGTACTAAACTA->TGCCGTAGTACTAAACTAA
TTGCCTCACCCGGTTCGCA->TGCCTCACCCGGTTCGCAA
TTGCGCTGCTCAATCCGAA->TGCGCTGCTCAATCCGAAC
TTGCGGTGGAACACGACAG->TGCGGTGGAACACGACAGC
TTGCTAGGCGCGTAGGGGA->TGCTAGGCGCGTAGGGGAC
TTGCTAGTGTCAACAGTCA->TGCTAGTGTCAACAGTCAG
TTGGAGATGGTTCAAATGC->TGGAGATGGTTCAAATGCG
TTGGAGTTTGCAACTAGCG->TGGAGTTTGCAACTAGCGT
TTGGATGACCTTGAGTAAT->TGGATGACCTTGAGTAATC
TTGGCATTTAGCCCCCCCG->TGGCATTTAGCCCCCCCGC
TTGGCCCCTCCATGCAAAT->TGGCCCCTCCATGCAAATT
TTGGTAACGTATCGCCTGA->TGGTAACGTATCGCCTGAT
TTGGTCATCTCGCAACTGT->TGGTCATCTCGCAACTGTA
TTGGTCCTTATGACCAGCC->TGGTCCTTATGACCAGCCT
TTGTCGTCTTTTGCGCTGC->TGTCGTCTTTTGCGCTGCT
TTGTCTGCGAGGTAGCATT->TGTCTGCGAGGTAGCATTC
TTGTGAATCGCAGTTAAGA->TGTGAATCGCAGTTAAGAT
TTGTGACTGATTCTGGTTA->TGTGACTGATTCTGGTTAG
TTGTTGGCATTTAGCCCCC->TGTTGGCATTTAGCCCCCC
TTGTTGTTGGCATTTAGCC->TGTTGTTGGCATTTAGCCC
TTTAGAGGGAGGGCTGTCG->TTAGAGGGAGGGCTGTCGT
TTTAGCCACCTGTCGCTGC->TTAGCCACCTGTCGCTGCT
TTTAGCCCCCCCGCCCCTA->TTAGCCCCCCCGCCCCTAC
TTTAGGTGCTCCTGGTCCG->TTAGGTGCTCCTGGTCCGA
TTTAGGTTTTATAAATCAT->TTAGGTTTTATAAATCATT
TTTAGTTGGTAACGTATCG->TTAGTTGGTAACGTATCGC
TTTATAAATCATTCCACCG->TTATAAATCATTCCACCGA
TTTCACTACCGCTCATACA->TTCACTACCGCTCATACAT
TTTCATTGCGGTGGAACAC->TTCATTGCGGTGGAACACG
TTTCCAGACGCAGATGAAT->TTCCAGACGCAGATGAATG
TTTCCCAGGGCTCCAGGAA->TTCCCAGGGCTCCAGGAAG
TTTCCCAGGGTCTTATACA->TTCCCAGGGTCTTATACAT
TTTCCCGCTCCTGGGGCCT->TTCCCGCTCCTGGGGCCTG
TTTCGAGAGGCATGACAAA->TTCGAGAGGCATGACAAAT
TTTGAGAATCAGTGAGAAA->TTGAGAATCAGTGAGAAAA
TTTGCAACTAGCGTCAGGC->TTGCAACTAGCGTCAGGCG
TTTGCCCGTCTGCTAACGG->TTGCCCGTCTGCTAACGGG
TTTGCGCTGCTCAATCCGA->TTGCGCTGCTCAATCCGAA
TTTGCTAGGCGCGTAGGGG->TTGCTAGGCGCGTAGGGGA
TTTGGTCATCTCGCAACTG->TTGGTCATCTCGCAACTGT
TTTGGTCCTTATGACCAGC->TTGGTCCTTATGACCAGCC
TTTGTGAATCGCAGTTAAG->TTGTGAATCGCAGTTAAGA
TTTGTGACTGATTCTGGTT->TTGTGACTGATTCTGGTTA
TTTGTTGTTGGCATTTAGC->TTGTTGTTGGCATTTAGCC
TTTTAGAGGGAGGGCTGTC->TTTAGAGGGAGGGCTGTCG
TTTTATAAATCATTCCACC->TTTATAAATCATTCCACCG
TTTTGCGCTGCTCAATCCG->TTTGCGCTGCTCAATCCGA
TTTTGGTCCTTATGACCAG->TTTGGTCCTTATGACCAGC
TTTTGTGAATCGCAGTTAA->TTTGTGAATCGCAGTTAAG
