AAAACGCATGC->AAACGCATGCT
AAAACTCGAGA->AAACTCGAGAG
AAAACTTCATG->AAACTTCATGC
AAAAGGATGTG->AAAGGATGTGA
AAAAGTGGATC->AAAGTGGATCA
AAAATACCCTT->AAATACCCTTC
AAACACCTTGC->AACACCTTGCA
AAACATCATTG->AACATCATTGC
AAACATGTTCT->AACATGTTCTC
AAACGATTGGG->AACGATTGGGC
AAACGCATGCT->AACGCATGCTC
AAACTCGAGAG->AACTCGAGAGG
AAACTTCATGC->AACTTCATGCC
AAAGAGACTTA->AAGAGACTTAA
AAAGGATGTGA->AAGGATGTGAG
AAAGTATTAAG->AAGTATTAAGA
AAAGTGGATCA->AAGTGGATCAT
AAATACCCTTC->AATACCCTTCA
AAATCCGCCAG->AATCCGCCAGC
AAATGCCCACT->AATGCCCACTT
AAATGGCTTTA->AATGGCTTTAG
AAATTGCGCGT->AATTGCGCGTT
AACAAGCGACC->ACAAGCGACCC
AACAATACCCG->ACAATACCCGC
AACACCTTGCA->ACACCTTGCAT
AACACGACGCC->ACACGACGCCA
AACACTGTACT->ACACTGTACTT
AACAGAACGAT->ACAGAACGATC
AACAGCGTTCT->ACAGCGTTCTG
AACAGGGAACG->ACAGGGAACGT
AACATCATTGC->ACATCATTGCT
AACATGTTCTC->ACATGTTCTCC
AACATTCACCT->ACATTCACCTA
AACCAGTATCT->ACCAGTATCTC
AACCATCACCA->ACCATCACCAG
AACCGTGCTAG->ACCGTGCTAGC
AACCTCTGGAC->ACCTCTGGACG
AACCTTAACAG->ACCTTAACAGG
AACGACCTCCA->ACGACCTCCAT
AACGAGCACGT->ACGAGCACGTT
AACGATCAATG->ACGATCAATGA
AACGATTGGGC->ACGATTGGGCT
AACGCACCTGA->ACGCACCTGAT
AACGCATGCTC->ACGCATGCTCG
AACGGGCTAAA->ACGGGCTAAAA
AACGTATGGTG->ACGTATGGTGG
AACGTGCGAAC->ACGTGCGAACT
AACTCCTGAGG->ACTCCTGAGGA
AACTCGAGAGG->ACTCGAGAGGC
AACTCTTACTC->ACTCTTACTCG
AACTTCAATGG->ACTTCAATGGT
AACTTCATGCC->ACTTCATGCCT
AACTTGATCTT->ACTTGATCTTT
AACTTGGGTTA->ACTTGGGTTAA
AACTTTAGAAC->ACTTTAGAACC
AAGACATGGGA->AGACATGGGAA
AAGAGACTTAA->AGAGACTTAAT
AAGAGCAATTA->AGAGCAATTAC
AAGAGGACCTC->AGAGGACCTCG
AAGAGGGAAGG->AGAGGGAAGGG
AAGATTGTGAT->AGATTGTGATC
AAGCAGCCTTT->AGCAGCCTTTA
AAGCAGTCCAA->AGCAGTCCAAG
AAGCATAGAAA->AGCATAGAAAA
AAGCATGTGTA->AGCATGTGTAC
AAGCCCTATAT->AGCCCTATATA
AAGCCCTTGTA->AGCCCTTGTAG
AAGCGACCCTG->AGCGACCCTGC
AAGCGGTTCCA->AGCGGTTCCAT
AAGCTCCAAAC->AGCTCCAAACG
AAGGATGTGAG->AGGATGTGAGT
AAGGCCAGGGC->AGGCCAGGGCT
AAGGCCAGTCA->AGGCCAGTCAC
AAGGGACTCTG->AGGGACTCTGA
AAGGGGAACAG->AGGGGAACAGC
AAGGTCCACAG->AGGTCCACAGA
AAGGTGTTTGA->AGGTGTTTGAT
AAGTAAAAGGA->AGTAAAAGGAT
AAGTAGACCTC->AGTAGACCTCT
AAGTAGTGAAC->AGTAGTGAACA
AAGTATTAAGA->AGTATTAAGAT
AAGTCGCTGGC->AGTCGCTGGCG
AAGTGGATCAT->AGTGGATCATT
AAGTGGGATAA->AGTGGGATAAG
AATAATACAAG->ATAATACAAGC
AATACAAGCTC->ATACAAGCTCC
AATACATGCGT->ATACATGCGTG
AATACCCGCGT->ATACCCGCGTA
AATACCCTTCA->ATACCCTTCAT
AATACTACAGA->ATACTACAGAC
AATAGAAGAGG->ATAGAAGAGGG
AATAGCCGCTA->ATAGCCGCTAA
AATAGGGTTTA->ATAGGGTTTAC
AATATCAACTT->ATATCAACTTT
AATATTAGAGT->ATATTAGAGTC
AATCCGCCAGC->ATCCGCCAGCG
AATCGCCGTAA->ATCGCCGTAAA
AATGAGTGGCT->ATGAGTGGCTT
AATGCACGAGG->ATGCACGAGGA
AATGCCCACTT->ATGCCCACTTT
AATGCTACACA->ATGCTACACAC
AATGGATCTGC->ATGGATCTGCG
AATGGCTTTAG->ATGGCTTTAGC
AATGGTTCACG->ATGGTTCACGT
AATGTGCTACG->ATGTGCTACGC
AATTACGGCGC->ATTACGGCGCT
AATTAGGTGGT->ATTAGGTGGTC
AATTCCTAACT->ATTCCTAACTT
AATTGCGCGTT->ATTGCGCGTTT
AATTGCGGCAA->ATTGCGGCAAT
AATTGTCAGGC->ATTGTCAGGCA
AATTTCCTTAC->ATTTCCTTACA
ACAACATTCAC->CAACATTCACC
ACAACCTTAAC->CAACCTTAACA
ACAACGGGCTA->CAACGGGCTAA
ACAAGCGACCC->CAAGCGACCCT
ACAAGCTCCAA->CAAGCTCCAAA
ACAAGTAAAAG->CAAGTAAAAGG
ACAATACCCGC->CAATACCCGCG
ACACAACGGGC->CACAACGGGCT
ACACACAACGG->CACACAACGGG
ACACACCGTAA->CACACCGTAAC
ACACCGTAACA->CACCGTAACAC
ACACCTCTTGC->CACCTCTTGCC
ACACCTTGCAT->CACCTTGCATA
ACACGACGCCA->CACGACGCCAC
ACACTGATAAT->CACTGATAATA
ACACTGTACTT->CACTGTACTTT
ACAGAACGATC->CAGAACGATCA
ACAGACGCATA->CAGACGCATAA
ACAGAGGATAA->CAGAGGATAAC
ACAGATGTTGT->CAGATGTTGTT
ACAGCAGGATC->CAGCAGGATCT
ACAGCGCATTA->CAGCGCATTAG
ACAGCGTTCTG->CAGCGTTCTGG
ACAGGGAACGT->CAGGGAACGTG
ACATCATTGCT->CATCATTGCTC
ACATCCAACCG->CATCCAACCGT
ACATCCTTCTC->CATCCTTCTCC
ACATGCCAGGC->CATGCCAGGCA
ACATGCGTGGC->CATGCGTGGCC
ACATGGGAAGC->CATGGGAAGCA
ACATGTTCTCC->CATGTTCTCCT
ACATTCACCTA->CATTCACCTAA
ACATTCCGATG->CATTCCGATGA
ACATTGCGTGT->CATTGCGTGTT
ACATTTTCTAG->CATTTTCTAGA
ACCAAGTAGAC->CCAAGTAGACC
ACCAATAGCCG->CCAATAGCCGC
ACCAGAGTTAC->CCAGAGTTACG
ACCAGTATCTC->CCAGTATCTCA
ACCAGTATTTC->CCAGTATTTCG
ACCATCACCAG->CCATCACCAGA
ACCCAGCGCGC->CCCAGCGCGCC
ACCCGCGTAGG->CCCGCGTAGGC
ACCCTGCTGAA->CCCTGCTGAAC
ACCCTTCATGC->CCCTTCATGCA
ACCGACATTGC->CCGACATTGCG
ACCGACCAATA->CCGACCAATAG
ACCGAGAGCCA->CCGAGAGCCAG
ACCGTAACACT->CCGTAACACTG
ACCGTGCTAGC->CCGTGCTAGCT
ACCTAAACATG->CCTAAACATGT
ACCTAGAGCGC->CCTAGAGCGCC
ACCTCCATCCA->CCTCCATCCAA
ACCTCGACTTA->CCTCGACTTAA
ACCTCTGGACG->CCTCTGGACGA
ACCTCTTGCCC->CCTCTTGCCCT
ACCTCTTGGAT->CCTCTTGGATT
ACCTGATGCGT->CCTGATGCGTT
ACCTGCTGCAA->CCTGCTGCAAT
ACCTTAACAGG->CCTTAACAGGG
ACCTTGCATAC->CCTTGCATACA
ACGAATTGCGG->CGAATTGCGGC
ACGACCCAGCG->CGACCCAGCGC
ACGACCTCCAT->CGACCTCCATC
ACGACGCCACA->CGACGCCACAA
ACGAGCACGTT->CGAGCACGTTT
ACGAGGATAAT->CGAGGATAATA
ACGATCAATGA->CGATCAATGAG
ACGATTCTCTA->CGATTCTCTAG
ACGATTGGGCT->CGATTGGGCTC
ACGCACCTGAT->CGCACCTGATG
ACGCATAATGC->CGCATAATGCT
ACGCATCCACC->CGCATCCACCA
ACGCATCCCCT->CGCATCCCCTT
ACGCATGCTCG->CGCATGCTCGG
ACGCCACAACC->CGCCACAACCT
ACGCGCGCAGG->CGCGCGCAGGG
ACGCGCGGCCG->CGCGCGGCCGG
ACGGCCTTTTA->CGGCCTTTTAT
ACGGCGCTCGG->CGGCGCTCGGA
ACGGGCTAAAA->CGGGCTAAAAC
ACGGTTTGTCC->CGGTTTGTCCC
ACGTAAGCAGT->CGTAAGCAGTC
ACGTATGGTGG->CGTATGGTGGT
ACGTGCGAACT->CGTGCGAACTC
ACGTGGTTTTG->CGTGGTTTTGC
ACGTGTTGAAG->CGTGTTGAAGC
ACGTTTCTTAT->CGTTTCTTATG
ACTACAGACGC->CTACAGACGCA
ACTACTAGACG->CTACTAGACGC
ACTAGACGCAT->CTAGACGCATC
ACTAGCCTGTG->CTAGCCTGTGG
ACTAGGCAATT->CTAGGCAATTC
ACTAGTGCAAT->CTAGTGCAATA
ACTATAAATTG->CTATAAATTGC
ACTATACTGTA->CTATACTGTAG
ACTATAGAACA->CTATAGAACAA
ACTATTTTAAG->CTATTTTAAGG
ACTCATTTAAT->CTCATTTAATA
ACTCCTGAGGA->CTCCTGAGGAG
ACTCGAGAGGC->CTCGAGAGGCC
ACTCGATTGCT->CTCGATTGCTG
ACTCGCATTGC->CTCGCATTGCA
ACTCTGAACAG->CTCTGAACAGA
ACTCTGAGTAT->CTCTGAGTATG
ACTCTTACTCG->CTCTTACTCGC
ACTGAACGAGC->CTGAACGAGCA
ACTGAGAGATT->CTGAGAGATTA
ACTGATAATAT->CTGATAATATT
ACTGTACTTTG->CTGTACTTTGA
ACTGTAGTGGG->CTGTAGTGGGG
ACTTAATCGCC->CTTAATCGCCG
ACTTAATGTGC->CTTAATGTGCT
ACTTCAATGGT->CTTCAATGGTT
ACTTCATGCCT->CTTCATGCCTG
ACTTCTTCCTA->CTTCTTCCTAT
ACTTGATCTTT->CTTGATCTTTC
ACTTGGGTTAA->CTTGGGTTAAT
ACTTTAGAACC->CTTTAGAACCT
ACTTTGACGCG->CTTTGACGCGC
ACTTTGGCCTC->CTTTGGCCTCC
ACTTTGTTCAA->CTTTGTTCAAA
AGAAAACGCAT->GAAAACGCATG
AGAACAATACC->GAACAATACCC
AGAACCTCTGG->GAACCTCTGGA
AGAACGATCAA->GAACGATCAAT
AGAAGAGGGAA->GAAGAGGGAAG
AGAAGCATAGA->GAAGCATAGAA
AGACAGAGGAT->GACAGAGGATA
AGACATGGGAA->GACATGGGAAG
AGACCTCTTGG->GACCTCTTGGA
AGACGCATAAT->GACGCATAATG
AGACGCATCCA->GACGCATCCAC
AGACGGTTTGT->GACGGTTTGTC
AGACTTAATCG->GACTTAATCGC
AGAGACTTAAT->GAGACTTAATC
AGAGATTATAA->GAGATTATAAA
AGAGCAATTAC->GAGCAATTACG
AGAGCCAGGTC->GAGCCAGGTCT
AGAGCGCCCGG->GAGCGCCCGGT
AGAGCTTTTTC->GAGCTTTTTCC
AGAGGACCTCG->GAGGACCTCGA
AGAGGATAACG->GAGGATAACGT
AGAGGCCTAAA->GAGGCCTAAAC
AGAGGGAAGGG->GAGGGAAGGGA
AGAGTCTTCGC->GAGTCTTCGCC
AGAGTTACGTG->GAGTTACGTGG
AGATACTACTA->GATACTACTAG
AGATCCCGACG->GATCCCGACGC
AGATCTGTCAC->GATCTGTCACC
AGATGTCTTTG->GATGTCTTTGG
AGATGTTGTTC->GATGTTGTTCA
AGATTATAAAG->GATTATAAAGA
AGATTGTGATC->GATTGTGATCC
AGCAATTACGG->GCAATTACGGC
AGCACGTTTCT->GCACGTTTCTT
AGCAGATCTGT->GCAGATCTGTC
AGCAGCCTTTA->GCAGCCTTTAT
AGCAGGATCTA->GCAGGATCTAC
AGCAGTCCAAG->GCAGTCCAAGG
AGCATACTGAG->GCATACTGAGA
AGCATAGAAAA->GCATAGAAAAC
AGCATGTACTT->GCATGTACTTT
AGCATGTGTAC->GCATGTGTACC
AGCCAGGTCTC->GCCAGGTCTCG
AGCCCTATATA->GCCCTATATAT
AGCCCTTGTAG->GCCCTTGTAGG
AGCCGCCCGTC->GCCGCCCGTCG
AGCCGCTAAGG->GCCGCTAAGGT
AGCCTGTGGCG->GCCTGTGGCGA
AGCCTTTATCT->GCCTTTATCTA
AGCGACCCTGC->GCGACCCTGCT
AGCGCATGCTT->GCGCATGCTTG
AGCGCATTAGG->GCGCATTAGGG
AGCGCCCGGTC->GCGCCCGGTCC
AGCGCGCCAGA->GCGCGCCAGAC
AGCGGGGTCGC->GCGGGGTCGCC
AGCGGTTCCAT->GCGGTTCCATC
AGCGTTCTGGA->GCGTTCTGGAG
AGCTAACCAGT->GCTAACCAGTA
AGCTAGTCATG->GCTAGTCATGG
AGCTCCAAACG->GCTCCAAACGA
AGCTCTACTCG->GCTCTACTCGA
AGCTTTTTCCC->GCTTTTTCCCG
AGGAATGGATC->GGAATGGATCT
AGGACCTCGAC->GGACCTCGACT
AGGAGGTGGAG->GGAGGTGGAGC
AGGATAACGTA->GGATAACGTAT
AGGATAATATC->GGATAATATCA
AGGATCTACAC->GGATCTACACA
AGGATGTGAGT->GGATGTGAGTG
AGGCAAGTGGG->GGCAAGTGGGA
AGGCAATTCCT->GGCAATTCCTA
AGGCACACTGA->GGCACACTGAT
AGGCACAGCAG->GGCACAGCAGG
AGGCCAGGGCT->GGCCAGGGCTC
AGGCCAGTCAC->GGCCAGTCACA
AGGCCTAAACA->GGCCTAAACAT
AGGCCTCACGA->GGCCTCACGAT
AGGCTTTTTGT->GGCTTTTTGTT
AGGGAACGTGC->GGGAACGTGCG
AGGGAAGGGAC->GGGAAGGGACT
AGGGACTCTGA->GGGACTCTGAG
AGGGCAAGCCC->GGGCAAGCCCT
AGGGCTCCAGA->GGGCTCCAGAC
AGGGGAACAGC->GGGGAACAGCG
AGGGGCTAATA->GGGGCTAATAC
AGGGGTATTTC->GGGGTATTTCG
AGGGTTTACGT->GGGTTTACGTA
AGGTATTATTC->GGTATTATTCT
AGGTCCACAGA->GGTCCACAGAT
AGGTCTCGTGG->GGTCTCGTGGT
AGGTGGAGCTC->GGTGGAGCTCT
AGGTGGTCGCG->GGTGGTCGCGC
AGGTGTTTGAT->GGTGTTTGATT
AGGTTTCTCCT->GGTTTCTCCTC
AGTAAAAGGAT->GTAAAAGGATG
AGTACTCTGAA->GTACTCTGAAC
AGTAGACCTCT->GTAGACCTCTT
AGTAGTGAACA->GTAGTGAACAC
AGTATCTCACT->GTATCTCACTA
AGTATGTTCAT->GTATGTTCATA
AGTATTAAGAT->GTATTAAGATT
AGTATTTCGCT->GTATTTCGCTC
AGTCACAGCGC->GTCACAGCGCA
AGTCATGGTTT->GTCATGGTTTG
AGTCCAAGGCC->GTCCAAGGCCA
AGTCGCTGGCG->GTCGCTGGCGC
AGTCTCCCAGG->GTCTCCCAGGG
AGTCTTCGCCA->GTCTTCGCCAA
AGTGAACACGA->GTGAACACGAC
AGTGATGGGTG->GTGATGGGTGG
AGTGCAATACT->GTGCAATACTA
AGTGGATCATT->GTGGATCATTG
AGTGGCTTATC->GTGGCTTATCC
AGTGGGATAAG->GTGGGATAAGA
AGTGGGGGTTG->GTGGGGGTTGC
AGTGTACCTGC->GTGTACCTGCT
AGTTACGTGGT->GTTACGTGGTT
AGTTCAATTAG->GTTCAATTAGG
AGTTGGCAGTC->GTTGGCAGTCT
AGTTTCCTTCC->GTTTCCTTCCC
ATAAACACCTT->TAAACACCTTG
ATAAAGAGACT->TAAAGAGACTT
ATAAATGCCCA->TAAATGCCCAC
ATAAATTGCGC->TAAATTGCGCG
ATAACGCACCT->TAACGCACCTG
ATAACGTATGG->TAACGTATGGT
ATAAGAGGACC->TAAGAGGACCT
ATAAGCGGTTC->TAAGCGGTTCC
ATAATACAAGC->TAATACAAGCT
ATAATAGGGTT->TAATAGGGTTT
ATAATATCAAC->TAATATCAACT
ATAATATTAGA->TAATATTAGAG
ATAATGCTACA->TAATGCTACAC
ATACAAGCTCC->TACAAGCTCCA
ATACATCCTTC->TACATCCTTCT
ATACATGCGTG->TACATGCGTGG
ATACCAAGTAG->TACCAAGTAGA
ATACCCGCGTA->TACCCGCGTAG
ATACCCTTCAT->TACCCTTCATG
ATACTACAGAC->TACTACAGACG
ATACTACTAGA->TACTACTAGAC
ATACTGAGAGA->TACTGAGAGAT
ATACTGTAGTG->TACTGTAGTGG
ATAGAAAACGC->TAGAAAACGCA
ATAGAACAATA->TAGAACAATAC
ATAGAAGAGGG->TAGAAGAGGGA
ATAGCCGCTAA->TAGCCGCTAAG
ATAGGGTTTAC->TAGGGTTTACG
ATAGTACTCTG->TAGTACTCTGA
ATATAAATGCC->TATAAATGCCC
ATATAGTACTC->TATAGTACTCT
ATATATATGTG->TATATATGTGA
ATATATGTGAA->TATATGTGAAT
ATATCAACTTT->TATCAACTTTA
ATATGCACACT->TATGCACACTT
ATATGTGAATT->TATGTGAATTG
ATATTAGAGTC->TATTAGAGTCT
ATCAACTTTAG->TCAACTTTAGA
ATCAATGAGTG->TCAATGAGTGG
ATCACCAGAGT->TCACCAGAGTT
ATCATTGCACA->TCATTGCACAT
ATCATTGCTCC->TCATTGCTCCG
ATCCAACCGTG->TCCAACCGTGC
ATCCAAGGCCA->TCCAAGGCCAG
ATCCACCAGTA->TCCACCAGTAT
ATCCCCTTTAG->TCCCCTTTAGC
ATCCCGACCGA->TCCCGACCGAC
ATCCCGACGCA->TCCCGACGCAT
ATCCGCCAGCG->TCCGCCAGCGG
ATCCGCTATAA->TCCGCTATAAG
ATCCTGGTCTG->TCCTGGTCTGC
ATCCTTCTCCC->TCCTTCTCCCT
ATCGACTATAG->TCGACTATAGA
ATCGCCCCTTC->TCGCCCCTTCA
ATCGCCGTAAA->TCGCCGTAAAT
ATCTACACACA->TCTACACACAA
ATCTACTGAAC->TCTACTGAACG
ATCTCACTATA->TCTCACTATAA
ATCTCTTGGAA->TCTCTTGGAAC
ATCTGCGCCTA->TCTGCGCCTAT
ATCTGTCACCG->TCTGTCACCGA
ATCTTGTTAAA->TCTTGTTAAAA
ATCTTTCCGCA->TCTTTCCGCAC
ATGAACCATCA->TGAACCATCAC
ATGAGGAATGG->TGAGGAATGGA
ATGAGTGGCTT->TGAGTGGCTTA
ATGCAAAGTAT->TGCAAAGTATT
ATGCACACTTT->TGCACACTTTC
ATGCACGAGGA->TGCACGAGGAT
ATGCAGTTGGC->TGCAGTTGGCA
ATGCCAGGCAC->TGCCAGGCACA
ATGCCCACTTT->TGCCCACTTTG
ATGCCTGGGCT->TGCCTGGGCTC
ATGCGTGGCCA->TGCGTGGCCAC
ATGCGTTTGAT->TGCGTTTGATG
ATGCTACACAC->TGCTACACACC
ATGCTCGGATT->TGCTCGGATTG
ATGCTTGGACA->TGCTTGGACAT
ATGGATCTCTT->TGGATCTCTTG
ATGGATCTGCG->TGGATCTGCGC
ATGGCCCCAAG->TGGCCCCAAGC
ATGGCTTTAGC->TGGCTTTAGCT
ATGGGAAGCAT->TGGGAAGCATG
ATGGGTGGGAA->TGGGTGGGAAC
ATGGTGGTAGA->TGGTGGTAGAT
ATGGTTCACGT->TGGTTCACGTG
ATGGTTTGGGA->TGGTTTGGGAT
ATGTACTTTGG->TGTACTTTGGC
ATGTCTTTGGA->TGTCTTTGGAC
ATGTGAATTGT->TGTGAATTGTC
ATGTGAGTGAT->TGTGAGTGATG
ATGTGCTACGC->TGTGCTACGCG
ATGTGTACCGA->TGTGTACCGAG
ATGTTCATAAA->TGTTCATAAAC
ATGTTCTCCTT->TGTTCTCCTTG
ATGTTGTTCAG->TGTTGTTCAGT
ATTAAGATTGT->TTAAGATTGTG
ATTAAGGGGAA->TTAAGGGGAAC
ATTACGGCGCT->TTACGGCGCTC
ATTACTAGGCA->TTACTAGGCAA
ATTACTAGTGC->TTACTAGTGCA
ATTAGAGTCTT->TTAGAGTCTTC
ATTAGGGCAAG->TTAGGGCAAGC
ATTAGGTGGTC->TTAGGTGGTCG
ATTATAAAGAG->TTATAAAGAGA
ATTATATAAAT->TTATATAAATG
ATTATCGCCCC->TTATCGCCCCT
ATTATTCTCAC->TTATTCTCACT
ATTCACCTAAA->TTCACCTAAAC
ATTCCGATGAA->TTCCGATGAAC
ATTCCTAACTT->TTCCTAACTTG
ATTCTCACTAT->TTCTCACTATA
ATTCTCTAGGT->TTCTCTAGGTA
ATTGAGATCCC->TTGAGATCCCG
ATTGCAACTTG->TTGCAACTTGG
ATTGCACATGC->TTGCACATGCC
ATTGCGAAGTC->TTGCGAAGTCG
ATTGCGCGTTT->TTGCGCGTTTT
ATTGCGGCAAT->TTGCGGCAATG
ATTGCGTGTTC->TTGCGTGTTCC
ATTGCTCCGCA->TTGCTCCGCAA
ATTGCTGACAT->TTGCTGACATT
ATTGGGCTCCG->TTGGGCTCCGC
ATTGGTTCCTG->TTGGTTCCTGT
ATTGTCAGGCA->TTGTCAGGCAA
ATTGTGATCCG->TTGTGATCCGC
ATTTAATAATA->TTTAATAATAC
ATTTCCGATAA->TTTCCGATAAC
ATTTCCTTACA->TTTCCTTACAT
ATTTCGATATA->TTTCGATATAG
ATTTCGCTCTC->TTTCGCTCTCC
ATTTTAAGGTG->TTTTAAGGTGT
ATTTTCTAGAT->TTTTCTAGATG
CAAAACTCGAG->AAAACTCGAGA
CAAAATACCCT->AAAATACCCTT
CAAACGATTGG->AAACGATTGGG
CAAAGTATTAA->AAAGTATTAAG
CAACATTCACC->AACATTCACCT
CAACCGTGCTA->AACCGTGCTAG
CAACCTTAACA->AACCTTAACAG
CAACGGGCTAA->AACGGGCTAAA
CAACTTGGGTT->AACTTGGGTTA
CAACTTTAGAA->AACTTTAGAAC
CAAGACATGGG->AAGACATGGGA
CAAGAGCAATT->AAGAGCAATTA
CAAGCAGCCTT->AAGCAGCCTTT
CAAGCCCTTGT->AAGCCCTTGTA
CAAGCGACCCT->AAGCGACCCTG
CAAGCTCCAAA->AAGCTCCAAAC
CAAGGCCAGGG->AAGGCCAGGGC
CAAGGCCAGTC->AAGGCCAGTCA
CAAGTAAAAGG->AAGTAAAAGGA
CAAGTAGACCT->AAGTAGACCTC
CAAGTGGGATA->AAGTGGGATAA
CAATACCCGCG->AATACCCGCGT
CAATACTACAG->AATACTACAGA
CAATAGCCGCT->AATAGCCGCTA
CAATGAGTGGC->AATGAGTGGCT
CAATGCACGAG->AATGCACGAGG
CAATGGTTCAC->AATGGTTCACG
CAATTACGGCG->AATTACGGCGC
CAATTAGGTGG->AATTAGGTGGT
CAATTCCTAAC->AATTCCTAACT
CAATTTCCTTA->AATTTCCTTAC
CACAACATTCA->ACAACATTCAC
CACAACCTTAA->ACAACCTTAAC
CACAACGGGCT->ACAACGGGCTA
CACACAACGGG->ACACAACGGGC
CACACCGTAAC->ACACCGTAACA
CACACTGATAA->ACACTGATAAT
CACAGATGTTG->ACAGATGTTGT
CACAGCAGGAT->ACAGCAGGATC
CACAGCGCATT->ACAGCGCATTA
CACATGCCAGG->ACATGCCAGGC
CACCAGAGTTA->ACCAGAGTTAC
CACCAGTATTT->ACCAGTATTTC
CACCGACATTG->ACCGACATTGC
CACCGTAACAC->ACCGTAACACT
CACCTAAACAT->ACCTAAACATG
CACCTAGAGCG->ACCTAGAGCGC
CACCTCTTGCC->ACCTCTTGCCC
CACCTGATGCG->ACCTGATGCGT
CACCTTGCATA->ACCTTGCATAC
CACGAATTGCG->ACGAATTGCGG
CACGACGCCAC->ACGACGCCACA
CACGAGGATAA->ACGAGGATAAT
CACGATTCTCT->ACGATTCTCTA
CACGGCCTTTT->ACGGCCTTTTA
CACGTGTTGAA->ACGTGTTGAAG
CACGTTTCTTA->ACGTTTCTTAT
CACTATAAATT->ACTATAAATTG
CACTATACTGT->ACTATACTGTA
CACTGATAATA->ACTGATAATAT
CACTGTACTTT->ACTGTACTTTG
CACTTCTTCCT->ACTTCTTCCTA
CACTTTGTTCA->ACTTTGTTCAA
CAGAACGATCA->AGAACGATCAA
CAGACAGAGGA->AGACAGAGGAT
CAGACGCATAA->AGACGCATAAT
CAGACGGTTTG->AGACGGTTTGT
CAGAGCTTTTT->AGAGCTTTTTC
CAGAGGATAAC->AGAGGATAACG
CAGAGTTACGT->AGAGTTACGTG
CAGATCTGTCA->AGATCTGTCAC
CAGATGTTGTT->AGATGTTGTTC
CAGCAGGATCT->AGCAGGATCTA
CAGCCTTTATC->AGCCTTTATCT
CAGCGCATTAG->AGCGCATTAGG
CAGCGCGCCAG->AGCGCGCCAGA
CAGCGGGGTCG->AGCGGGGTCGC
CAGCGTTCTGG->AGCGTTCTGGA
CAGGATCTACA->AGGATCTACAC
CAGGCAAGTGG->AGGCAAGTGGG
CAGGCACACTG->AGGCACACTGA
CAGGGAACGTG->AGGGAACGTGC
CAGGGCTCCAG->AGGGCTCCAGA
CAGGGGCTAAT->AGGGGCTAATA
CAGGGGTATTT->AGGGGTATTTC
CAGGTCTCGTG->AGGTCTCGTGG
CAGTATCTCAC->AGTATCTCACT
CAGTATTTCGC->AGTATTTCGCT
CAGTCACAGCG->AGTCACAGCGC
CAGTCCAAGGC->AGTCCAAGGCC
CAGTCTCCCAG->AGTCTCCCAGG
CAGTGTACCTG->AGTGTACCTGC
CAGTTCAATTA->AGTTCAATTAG
CAGTTGGCAGT->AGTTGGCAGTC
CAGTTTCCTTC->AGTTTCCTTCC
CATAAACACCT->ATAAACACCTT
CATAATAGGGT->ATAATAGGGTT
CATAATGCTAC->ATAATGCTACA
CATACATCCTT->ATACATCCTTC
CATACTGAGAG->ATACTGAGAGA
CATAGAAAACG->ATAGAAAACGC
CATCACCAGAG->ATCACCAGAGT
CATCATTGCTC->ATCATTGCTCC
CATCCAACCGT->ATCCAACCGTG
CATCCAAGGCC->ATCCAAGGCCA
CATCCACCAGT->ATCCACCAGTA
CATCCCCTTTA->ATCCCCTTTAG
CATCCTTCTCC->ATCCTTCTCCC
CATCGACTATA->ATCGACTATAG
CATGCAAAGTA->ATGCAAAGTAT
CATGCAGTTGG->ATGCAGTTGGC
CATGCCAGGCA->ATGCCAGGCAC
CATGCCTGGGC->ATGCCTGGGCT
CATGCGTGGCC->ATGCGTGGCCA
CATGCTCGGAT->ATGCTCGGATT
CATGCTTGGAC->ATGCTTGGACA
CATGGGAAGCA->ATGGGAAGCAT
CATGGTTTGGG->ATGGTTTGGGA
CATGTACTTTG->ATGTACTTTGG
CATGTGTACCG->ATGTGTACCGA
CATGTTCTCCT->ATGTTCTCCTT
CATTAAGGGGA->ATTAAGGGGAA
CATTAGGGCAA->ATTAGGGCAAG
CATTCACCTAA->ATTCACCTAAA
CATTCCGATGA->ATTCCGATGAA
CATTGCAACTT->ATTGCAACTTG
CATTGCACATG->ATTGCACATGC
CATTGCGTGTT->ATTGCGTGTTC
CATTGCTCCGC->ATTGCTCCGCA
CATTGGTTCCT->ATTGGTTCCTG
CATTTAATAAT->ATTTAATAATA
CATTTCCGATA->ATTTCCGATAA
CATTTTCTAGA->ATTTTCTAGAT
CCAAACGATTG->CAAACGATTGG
CCAACCGTGCT->CAACCGTGCTA
CCAAGAGCAAT->CAAGAGCAATT
CCAAGCAGCCT->CAAGCAGCCTT
CCAAGGCCAGG->CAAGGCCAGGG
CCAAGGCCAGT->CAAGGCCAGTC
CCAAGTAGACC->CAAGTAGACCT
CCAATAGCCGC->CAATAGCCGCT
CCACAACCTTA->CACAACCTTAA
CCACAGATGTT->CACAGATGTTG
CCACCAGTATT->CACCAGTATTT
CCACCTAGAGC->CACCTAGAGCG
CCACTTTGTTC->CACTTTGTTCA
CCAGACAGAGG->CAGACAGAGGA
CCAGACGGTTT->CAGACGGTTTG
CCAGAGCTTTT->CAGAGCTTTTT
CCAGAGTTACG->CAGAGTTACGT
CCAGCGCGCCA->CAGCGCGCCAG
CCAGCGGGGTC->CAGCGGGGTCG
CCAGGCACACT->CAGGCACACTG
CCAGGGCTCCA->CAGGGCTCCAG
CCAGGGGTATT->CAGGGGTATTT
CCAGGTCTCGT->CAGGTCTCGTG
CCAGTATCTCA->CAGTATCTCAC
CCAGTATTTCG->CAGTATTTCGC
CCAGTCACAGC->CAGTCACAGCG
CCAGTTTCCTT->CAGTTTCCTTC
CCATAATAGGG->CATAATAGGGT
CCATCACCAGA->CATCACCAGAG
CCATCCAAGGC->CATCCAAGGCC
CCATCGACTAT->CATCGACTATA
CCATGCAAAGT->CATGCAAAGTA
CCATTAAGGGG->CATTAAGGGGA
CCATTGGTTCC->CATTGGTTCCT
CCCAAGCAGCC->CCAAGCAGCCT
CCCACTTTGTT->CCACTTTGTTC
CCCAGCGCGCC->CCAGCGCGCCA
CCCAGGGGTAT->CCAGGGGTATT
CCCAGTTTCCT->CCAGTTTCCTT
CCCATGCAAAG->CCATGCAAAGT
CCCATTAAGGG->CCATTAAGGGG
CCCATTGGTTC->CCATTGGTTCC
CCCCAAGCAGC->CCCAAGCAGCC
CCCCATTAAGG->CCCATTAAGGG
CCCCTGCGGCG->CCCTGCGGCGA
CCCCTTCATTT->CCCTTCATTTC
CCCCTTTAGCG->CCCTTTAGCGC
CCCGACCGACC->CCGACCGACCA
CCCGACGCATC->CCGACGCATCC
CCCGCGTAGGC->CCGCGTAGGCA
CCCGGAGGTTT->CCGGAGGTTTC
CCCGGATTACT->CCGGATTACTA
CCCGGTCCTAG->CCGGTCCTAGA
CCCGTCGCGGC->CCGTCGCGGCA
CCCTATATATA->CCTATATATAT
CCCTGAGCATA->CCTGAGCATAC
CCCTGCGGCGA->CCTGCGGCGAT
CCCTGCTGAAC->CCTGCTGAACT
CCCTTCATGCA->CCTTCATGCAG
CCCTTCATTTC->CCTTCATTTCC
CCCTTCTGCCG->CCTTCTGCCGA
CCCTTGTAGGC->CCTTGTAGGCC
CCCTTTAGCGC->CCTTTAGCGCA
CCGAAATGGCT->CGAAATGGCTT
CCGACATTGCG->CGACATTGCGT
CCGACCAATAG->CGACCAATAGC
CCGACCGACCA->CGACCGACCAA
CCGACGCATCC->CGACGCATCCC
CCGAGAGCCAG->CGAGAGCCAGG
CCGAGCATGTA->CGAGCATGTAC
CCGATAACGCA->CGATAACGCAC
CCGATCTTGTT->CGATCTTGTTA
CCGATGAACCA->CGATGAACCAT
CCGCAAGACAT->CGCAAGACATG
CCGCACGAATT->CGCACGAATTG
CCGCCAGCGGG->CGCCAGCGGGG
CCGCCCGTCGC->CGCCCGTCGCG
CCGCGTAGGCA->CGCGTAGGCAC
CCGCTAAGGTC->CGCTAAGGTCC
CCGCTATAAGC->CGCTATAAGCG
CCGCTTGGGTG->CGCTTGGGTGG
CCGGAGGTTTC->CGGAGGTTTCT
CCGGATTACTA->CGGATTACTAG
CCGGTAGGCTT->CGGTAGGCTTT
CCGGTCCTAGA->CGGTCCTAGAA
CCGTAAATCCG->CGTAAATCCGC
CCGTAACACTG->CGTAACACTGT
CCGTCGCGGCA->CGTCGCGGCAA
CCGTCTTCAGT->CGTCTTCAGTT
CCGTGCTAGCT->CGTGCTAGCTA
CCTAAACATCA->CTAAACATCAT
CCTAAACATGT->CTAAACATGTT
CCTAACTTGAT->CTAACTTGATC
CCTAGAAGCAT->CTAGAAGCATA
CCTAGAGCGCC->CTAGAGCGCCC
CCTATATATAT->CTATATATATG
CCTATATGCAC->CTATATGCACA
CCTATTACTAG->CTATTACTAGT
CCTCACGATTC->CTCACGATTCT
CCTCCATCCAA->CTCCATCCAAG
CCTCCGATCTT->CTCCGATCTTG
CCTCCGTCTTC->CTCCGTCTTCA
CCTCGACTTAA->CTCGACTTAAT
CCTCTGGACGA->CTCTGGACGAC
CCTCTTGCCCT->CTCTTGCCCTG
CCTCTTGGATT->CTCTTGGATTA
CCTGAGCATAC->CTGAGCATACT
CCTGAGGAGGT->CTGAGGAGGTG
CCTGATGCGTT->CTGATGCGTTT
CCTGCGGCGAT->CTGCGGCGATA
CCTGCTGAACT->CTGCTGAACTT
CCTGCTGCAAT->CTGCTGCAATT
CCTGGGCTCCC->CTGGGCTCCCC
CCTGGTCTGCG->CTGGTCTGCGG
CCTGTAACGAC->CTGTAACGACC
CCTGTGGCGAC->CTGTGGCGACT
CCTTAACAGGG->CTTAACAGGGA
CCTTACATCCA->CTTACATCCAA
CCTTCATGCAG->CTTCATGCAGT
CCTTCATTTCC->CTTCATTTCCG
CCTTCCCCTGC->CTTCCCCTGCG
CCTTCTCCCTT->CTTCTCCCTTC
CCTTCTGCCGA->CTTCTGCCGAG
CCTTGCATACA->CTTGCATACAT
CCTTGCCAGAG->CTTGCCAGAGC
CCTTGCCGAAA->CTTGCCGAAAT
CCTTGTAGGCC->CTTGTAGGCCT
CCTTTAGCGCA->CTTTAGCGCAT
CCTTTATCTAC->CTTTATCTACT
CCTTTTATCCC->CTTTTATCCCG
CGAAATGGCTT->GAAATGGCTTT
CGAACTCCTGA->GAACTCCTGAG
CGAAGTCGCTG->GAAGTCGCTGG
CGAATTGCGGC->GAATTGCGGCA
CGACAAGTAAA->GACAAGTAAAA
CGACATTGCGT->GACATTGCGTG
CGACCAATAGC->GACCAATAGCC
CGACCCAGCGC->GACCCAGCGCG
CGACCCTGCTG->GACCCTGCTGA
CGACCGACCAA->GACCGACCAAT
CGACCTCCATC->GACCTCCATCC
CGACGCATCCC->GACGCATCCCC
CGACGCCACAA->GACGCCACAAC
CGACTATAGAA->GACTATAGAAC
CGACTATTTTA->GACTATTTTAA
CGACTTAATGT->GACTTAATGTG
CGAGAGCCAGG->GAGAGCCAGGT
CGAGAGGCCTA->GAGAGGCCTAA
CGAGCACGTTT->GAGCACGTTTC
CGAGCATGTAC->GAGCATGTACT
CGAGGATAATA->GAGGATAATAT
CGATAACGCAC->GATAACGCACC
CGATACCAAGT->GATACCAAGTA
CGATATAGTAC->GATATAGTACT
CGATCAATGAG->GATCAATGAGT
CGATCTTGTTA->GATCTTGTTAA
CGATGAACCAT->GATGAACCATC
CGATTCTCTAG->GATTCTCTAGG
CGATTGCTGAC->GATTGCTGACA
CGATTGGGCTC->GATTGGGCTCC
CGCAAGACATG->GCAAGACATGG
CGCACCTGATG->GCACCTGATGC
CGCACGAATTG->GCACGAATTGC
CGCAGGGGCTA->GCAGGGGCTAA
CGCATAATGCT->GCATAATGCTA
CGCATCCACCA->GCATCCACCAG
CGCATCCCCTT->GCATCCCCTTT
CGCATGCTCGG->GCATGCTCGGA
CGCATGCTTGG->GCATGCTTGGA
CGCATTAGGGC->GCATTAGGGCA
CGCATTGCAAC->GCATTGCAACT
CGCCAAGAGCA->GCCAAGAGCAA
CGCCACAACCT->GCCACAACCTT
CGCCAGACAGA->GCCAGACAGAG
CGCCAGCGGGG->GCCAGCGGGGT
CGCCATAATAG->GCCATAATAGG
CGCCCCTTCAT->GCCCCTTCATT
CGCCCGGTCCT->GCCCGGTCCTA
CGCCCGTCGCG->GCCCGTCGCGG
CGCCGTAAATC->GCCGTAAATCC
CGCCTATTACT->GCCTATTACTA
CGCCTTGCCGA->GCCTTGCCGAA
CGCGCAGGGGC->GCGCAGGGGCT
CGCGCCAGACA->GCGCCAGACAG
CGCGCCATAAT->GCGCCATAATA
CGCGCGCAGGG->GCGCGCAGGGG
CGCGCGGCCGG->GCGCGGCCGGT
CGCGGCAAAAT->GCGGCAAAATA
CGCGGCCGGTA->GCGGCCGGTAG
CGCGTAGGCAC->GCGTAGGCACA
CGCGTGTTGAG->GCGTGTTGAGC
CGCGTTTTAAG->GCGTTTTAAGT
CGCTAAGGTCC->GCTAAGGTCCA
CGCTATAAGCG->GCTATAAGCGG
CGCTCACTTCT->GCTCACTTCTT
CGCTCGGACTA->GCTCGGACTAG
CGCTCTCCCAT->GCTCTCCCATG
CGCTGGCGCGT->GCTGGCGCGTG
CGCTTGGGTGG->GCTTGGGTGGG
CGGACTAGCCT->GGACTAGCCTG
CGGAGGTTTCT->GGAGGTTTCTC
CGGATTACTAG->GGATTACTAGG
CGGATTGCGAA->GGATTGCGAAG
CGGCAAAATAC->GGCAAAATACC
CGGCAATGCAC->GGCAATGCACG
CGGCCGGTAGG->GGCCGGTAGGC
CGGCCTTTTAT->GGCCTTTTATC
CGGCGATACCA->GGCGATACCAA
CGGCGCTCGGA->GGCGCTCGGAC
CGGGCTAAAAC->GGGCTAAAACT
CGGGGTCGCCT->GGGGTCGCCTT
CGGGTGCTGGT->GGGTGCTGGTT
CGGTAGGCTTT->GGTAGGCTTTT
CGGTCCTAGAA->GGTCCTAGAAG
CGGTTCCATCG->GGTTCCATCGA
CGGTTTGTCCC->GGTTTGTCCCG
CGTAAATCCGC->GTAAATCCGCC
CGTAACACTGT->GTAACACTGTA
CGTAAGCAGTC->GTAAGCAGTCC
CGTAGGCACAG->GTAGGCACAGC
CGTATGGTGGT->GTATGGTGGTA
CGTCGCGGCAA->GTCGCGGCAAA
CGTCTTCAGTT->GTCTTCAGTTC
CGTGCGAACTC->GTGCGAACTCC
CGTGCTAGCTA->GTGCTAGCTAA
CGTGGCCACCT->GTGGCCACCTA
CGTGGTGCACA->GTGGTGCACAA
CGTGGTTTTGC->GTGGTTTTGCC
CGTGTTCCCAT->GTGTTCCCATT
CGTGTTGAAGC->GTGTTGAAGCC
CGTGTTGAGCA->GTGTTGAGCAG
CGTTCTGGAGC->GTTCTGGAGCC
CGTTTCTTATG->GTTTCTTATGA
CGTTTGATGGA->GTTTGATGGAT
CGTTTTAAGTA->GTTTTAAGTAG
CTAAAACTTCA->TAAAACTTCAT
CTAAACATCAT->TAAACATCATT
CTAAACATGTT->TAAACATGTTC
CTAACCAGTAT->TAACCAGTATC
CTAACTTGATC->TAACTTGATCT
CTAAGGTCCAC->TAAGGTCCACA
CTAATACATGC->TAATACATGCG
CTACACACAAC->TACACACAACG
CTACACACCGT->TACACACCGTA
CTACAGACGCA->TACAGACGCAT
CTACGCGCGGC->TACGCGCGGCC
CTACTAGACGC->TACTAGACGCA
CTACTCATTTA->TACTCATTTAA
CTACTCGATTG->TACTCGATTGC
CTACTGAACGA->TACTGAACGAG
CTAGAAGCATA->TAGAAGCATAG
CTAGACGCATC->TAGACGCATCC
CTAGAGCGCCC->TAGAGCGCCCG
CTAGATGTCTT->TAGATGTCTTT
CTAGCCTGTGG->TAGCCTGTGGC
CTAGCTAACCA->TAGCTAACCAG
CTAGGCAATTC->TAGGCAATTCC
CTAGGTATTAT->TAGGTATTATT
CTAGTCATGGT->TAGTCATGGTT
CTAGTGCAATA->TAGTGCAATAC
CTATAAATTGC->TATAAATTGCG
CTATAAGCGGT->TATAAGCGGTT
CTATACTGTAG->TATACTGTAGT
CTATAGAACAA->TATAGAACAAT
CTATATATATG->TATATATATGT
CTATATGCACA->TATATGCACAC
CTATTACTAGT->TATTACTAGTG
CTATTTTAAGG->TATTTTAAGGT
CTCACGATTCT->TCACGATTCTC
CTCACTATAAA->TCACTATAAAT
CTCACTATACT->TCACTATACTG
CTCACTTCTTC->TCACTTCTTCC
CTCATTTAATA->TCATTTAATAA
CTCCAAACGAT->TCCAAACGATT
CTCCAGACGGT->TCCAGACGGTT
CTCCATCCAAG->TCCATCCAAGG
CTCCCAGGGGT->TCCCAGGGGTA
CTCCCATGCAA->TCCCATGCAAA
CTCCCCATTAA->TCCCCATTAAG
CTCCCTTCTGC->TCCCTTCTGCC
CTCCGATCTTG->TCCGATCTTGT
CTCCGCAAGAC->TCCGCAAGACA
CTCCGCTTGGG->TCCGCTTGGGT
CTCCGTCTTCA->TCCGTCTTCAG
CTCCTCCGATC->TCCTCCGATCT
CTCCTGAGGAG->TCCTGAGGAGG
CTCCTTGCCAG->TCCTTGCCAGA
CTCGACTTAAT->TCGACTTAATG
CTCGAGAGGCC->TCGAGAGGCCT
CTCGATTGCTG->TCGATTGCTGA
CTCGCATTGCA->TCGCATTGCAA
CTCGGACTAGC->TCGGACTAGCC
CTCGGATTGCG->TCGGATTGCGA
CTCGTGGTGCA->TCGTGGTGCAC
CTCTACTCGAT->TCTACTCGATT
CTCTAGGTATT->TCTAGGTATTA
CTCTCCCATGC->TCTCCCATGCA
CTCTGAACAGA->TCTGAACAGAA
CTCTGAGTATG->TCTGAGTATGT
CTCTGGACGAC->TCTGGACGACC
CTCTTACTCGC->TCTTACTCGCA
CTCTTGCCCTG->TCTTGCCCTGA
CTCTTGGAACA->TCTTGGAACAA
CTCTTGGATTA->TCTTGGATTAT
CTGAACAGAAC->TGAACAGAACG
CTGAACGAGCA->TGAACGAGCAC
CTGAACTTCAA->TGAACTTCAAT
CTGACATTCCG->TGACATTCCGA
CTGAGAGATTA->TGAGAGATTAT
CTGAGCATACT->TGAGCATACTG
CTGAGGAGGTG->TGAGGAGGTGG
CTGAGTATGTT->TGAGTATGTTC
CTGATAATATT->TGATAATATTA
CTGATGCGTTT->TGATGCGTTTG
CTGCAATTTCC->TGCAATTTCCT
CTGCCGAGCAT->TGCCGAGCATG
CTGCGCCTATT->TGCGCCTATTA
CTGCGGCGATA->TGCGGCGATAC
CTGCGGGTGCT->TGCGGGTGCTG
CTGCTGAACTT->TGCTGAACTTC
CTGCTGCAATT->TGCTGCAATTT
CTGGACGACCC->TGGACGACCCA
CTGGAGCCGCC->TGGAGCCGCCC
CTGGCGCGTGT->TGGCGCGTGTT
CTGGGCTCCCC->TGGGCTCCCCA
CTGGTCTGCGG->TGGTCTGCGGG
CTGGTTCGCTC->TGGTTCGCTCA
CTGTAACGACC->TGTAACGACCT
CTGTACTTTGA->TGTACTTTGAC
CTGTAGTGGGG->TGTAGTGGGGG
CTGTCACCGAC->TGTCACCGACA
CTGTGGCGACT->TGTGGCGACTA
CTTAACAGGGA->TTAACAGGGAA
CTTAATCGCCG->TTAATCGCCGT
CTTAATGTGCT->TTAATGTGCTA
CTTACATCCAA->TTACATCCAAC
CTTACTCGCAT->TTACTCGCATT
CTTATCCTGGT->TTATCCTGGTC
CTTATGAGGAA->TTATGAGGAAT
CTTCAATGGTT->TTCAATGGTTC
CTTCAGTTCAA->TTCAGTTCAAT
CTTCATGCAGT->TTCATGCAGTT
CTTCATGCCTG->TTCATGCCTGG
CTTCATTTCCG->TTCATTTCCGA
CTTCCCCTGCG->TTCCCCTGCGG
CTTCCTATATG->TTCCTATATGC
CTTCGCCAAGA->TTCGCCAAGAG
CTTCTCCCTTC->TTCTCCCTTCT
CTTCTGCCGAG->TTCTGCCGAGC
CTTCTTCCTAT->TTCTTCCTATA
CTTGATCTTTC->TTGATCTTTCC
CTTGCATACAT->TTGCATACATC
CTTGCCAGAGC->TTGCCAGAGCT
CTTGCCCTGAG->TTGCCCTGAGC
CTTGCCGAAAT->TTGCCGAAATG
CTTGGAACAAG->TTGGAACAAGC
CTTGGACATTT->TTGGACATTTT
CTTGGATTATC->TTGGATTATCG
CTTGGGTGGGA->TTGGGTGGGAT
CTTGGGTTAAT->TTGGGTTAATA
CTTGTAGGCCT->TTGTAGGCCTC
CTTGTTAAAAG->TTGTTAAAAGT
CTTTAGAACCT->TTTAGAACCTC
CTTTAGCGCAT->TTTAGCGCATG
CTTTAGCTAGT->TTTAGCTAGTC
CTTTATCTACT->TTTATCTACTG
CTTTCCGCACG->TTTCCGCACGA
CTTTGACGCGC->TTTGACGCGCG
CTTTGGACACC->TTTGGACACCT
CTTTGGCCTCC->TTTGGCCTCCG
CTTTGTTCAAA->TTTGTTCAAAA
CTTTTATCCCG->TTTTATCCCGA
CTTTTTCCCGG->TTTTTCCCGGA
CTTTTTGTTTC->TTTTTGTTTCG
GAAAACGCATG->AAAACGCATGC
GAAATGGCTTT->AAATGGCTTTA
GAACAAGCGAC->AACAAGCGACC
GAACAATACCC->AACAATACCCG
GAACACGACGC->AACACGACGCC
GAACAGAACGA->AACAGAACGAT
GAACAGCGTTC->AACAGCGTTCT
GAACCATCACC->AACCATCACCA
GAACCTCTGGA->AACCTCTGGAC
GAACGAGCACG->AACGAGCACGT
GAACGATCAAT->AACGATCAATG
GAACGTGCGAA->AACGTGCGAAC
GAACTCCTGAG->AACTCCTGAGG
GAACTCTTACT->AACTCTTACTC
GAACTTCAATG->AACTTCAATGG
GAAGAGGGAAG->AAGAGGGAAGG
GAAGCATAGAA->AAGCATAGAAA
GAAGCATGTGT->AAGCATGTGTA
GAAGCCCTATA->AAGCCCTATAT
GAAGGGACTCT->AAGGGACTCTG
GAAGTCGCTGG->AAGTCGCTGGC
GAATGGATCTG->AATGGATCTGC
GAATTGCGGCA->AATTGCGGCAA
GAATTGTCAGG->AATTGTCAGGC
GACAAGTAAAA->ACAAGTAAAAG
GACACCTCTTG->ACACCTCTTGC
GACAGAGGATA->ACAGAGGATAA
GACATGGGAAG->ACATGGGAAGC
GACATTCCGAT->ACATTCCGATG
GACATTGCGTG->ACATTGCGTGT
GACATTTTCTA->ACATTTTCTAG
GACCAATAGCC->ACCAATAGCCG
GACCCAGCGCG->ACCCAGCGCGC
GACCCTGCTGA->ACCCTGCTGAA
GACCGACCAAT->ACCGACCAATA
GACCTCCATCC->ACCTCCATCCA
GACCTCGACTT->ACCTCGACTTA
GACCTCTTGGA->ACCTCTTGGAT
GACGACCCAGC->ACGACCCAGCG
GACGCATAATG->ACGCATAATGC
GACGCATCCAC->ACGCATCCACC
GACGCATCCCC->ACGCATCCCCT
GACGCCACAAC->ACGCCACAACC
GACGCGCGCAG->ACGCGCGCAGG
GACGGTTTGTC->ACGGTTTGTCC
GACTAGCCTGT->ACTAGCCTGTG
GACTATAGAAC->ACTATAGAACA
GACTATTTTAA->ACTATTTTAAG
GACTCTGAGTA->ACTCTGAGTAT
GACTTAATCGC->ACTTAATCGCC
GACTTAATGTG->ACTTAATGTGC
GAGACTTAATC->AGACTTAATCG
GAGAGATTATA->AGAGATTATAA
GAGAGCCAGGT->AGAGCCAGGTC
GAGAGGCCTAA->AGAGGCCTAAA
GAGATCCCGAC->AGATCCCGACG
GAGATTATAAA->AGATTATAAAG
GAGCAATTACG->AGCAATTACGG
GAGCACGTTTC->AGCACGTTTCT
GAGCAGATCTG->AGCAGATCTGT
GAGCATACTGA->AGCATACTGAG
GAGCATGTACT->AGCATGTACTT
GAGCCAGGTCT->AGCCAGGTCTC
GAGCCGCCCGT->AGCCGCCCGTC
GAGCGCCCGGT->AGCGCCCGGTC
GAGCTCTACTC->AGCTCTACTCG
GAGCTTTTTCC->AGCTTTTTCCC
GAGGAATGGAT->AGGAATGGATC
GAGGACCTCGA->AGGACCTCGAC
GAGGAGGTGGA->AGGAGGTGGAG
GAGGATAACGT->AGGATAACGTA
GAGGATAATAT->AGGATAATATC
GAGGCCTAAAC->AGGCCTAAACA
GAGGGAAGGGA->AGGGAAGGGAC
GAGGTGGAGCT->AGGTGGAGCTC
GAGGTTTCTCC->AGGTTTCTCCT
GAGTATGTTCA->AGTATGTTCAT
GAGTCTTCGCC->AGTCTTCGCCA
GAGTGATGGGT->AGTGATGGGTG
GAGTGGCTTAT->AGTGGCTTATC
GAGTTACGTGG->AGTTACGTGGT
GATAACGCACC->ATAACGCACCT
GATAACGTATG->ATAACGTATGG
GATAAGAGGAC->ATAAGAGGACC
GATAATATCAA->ATAATATCAAC
GATAATATTAG->ATAATATTAGA
GATACCAAGTA->ATACCAAGTAG
GATACTACTAG->ATACTACTAGA
GATATAGTACT->ATATAGTACTC
GATCAATGAGT->ATCAATGAGTG
GATCATTGCAC->ATCATTGCACA
GATCCCGACGC->ATCCCGACGCA
GATCCGCTATA->ATCCGCTATAA
GATCTACACAC->ATCTACACACA
GATCTCTTGGA->ATCTCTTGGAA
GATCTGCGCCT->ATCTGCGCCTA
GATCTGTCACC->ATCTGTCACCG
GATCTTGTTAA->ATCTTGTTAAA
GATCTTTCCGC->ATCTTTCCGCA
GATGAACCATC->ATGAACCATCA
GATGCGTTTGA->ATGCGTTTGAT
GATGGATCTCT->ATGGATCTCTT
GATGGCCCCAA->ATGGCCCCAAG
GATGGGTGGGA->ATGGGTGGGAA
GATGTCTTTGG->ATGTCTTTGGA
GATGTGAGTGA->ATGTGAGTGAT
GATGTTGTTCA->ATGTTGTTCAG
GATTACTAGGC->ATTACTAGGCA
GATTATAAAGA->ATTATAAAGAG
GATTATATAAA->ATTATATAAAT
GATTATCGCCC->ATTATCGCCCC
GATTCTCTAGG->ATTCTCTAGGT
GATTGAGATCC->ATTGAGATCCC
GATTGCGAAGT->ATTGCGAAGTC
GATTGCTGACA->ATTGCTGACAT
GATTGGGCTCC->ATTGGGCTCCG
GATTGTGATCC->ATTGTGATCCG
GCAAAATACCC->CAAAATACCCT
GCAAAGTATTA->CAAAGTATTAA
GCAACTTGGGT->CAACTTGGGTT
GCAAGACATGG->CAAGACATGGG
GCAAGCCCTTG->CAAGCCCTTGT
GCAAGTGGGAT->CAAGTGGGATA
GCAATACTACA->CAATACTACAG
GCAATGCACGA->CAATGCACGAG
GCAATTACGGC->CAATTACGGCG
GCAATTCCTAA->CAATTCCTAAC
GCAATTTCCTT->CAATTTCCTTA
GCACAACATTC->CACAACATTCA
GCACACTGATA->CACACTGATAA
GCACAGCAGGA->CACAGCAGGAT
GCACATGCCAG->CACATGCCAGG
GCACCTGATGC->CACCTGATGCG
GCACGAATTGC->CACGAATTGCG
GCACGAGGATA->CACGAGGATAA
GCACGGCCTTT->CACGGCCTTTT
GCACGTTTCTT->CACGTTTCTTA
GCAGATCTGTC->CAGATCTGTCA
GCAGCCTTTAT->CAGCCTTTATC
GCAGGATCTAC->CAGGATCTACA
GCAGGGGCTAA->CAGGGGCTAAT
GCAGTCCAAGG->CAGTCCAAGGC
GCAGTCTCCCA->CAGTCTCCCAG
GCAGTTGGCAG->CAGTTGGCAGT
GCATAATGCTA->CATAATGCTAC
GCATACATCCT->CATACATCCTT
GCATACTGAGA->CATACTGAGAG
GCATAGAAAAC->CATAGAAAACG
GCATCCACCAG->CATCCACCAGT
GCATCCCCTTT->CATCCCCTTTA
GCATGCTCGGA->CATGCTCGGAT
GCATGCTTGGA->CATGCTTGGAC
GCATGTACTTT->CATGTACTTTG
GCATGTGTACC->CATGTGTACCG
GCATTAGGGCA->CATTAGGGCAA
GCATTGCAACT->CATTGCAACTT
GCCAAGAGCAA->CCAAGAGCAAT
GCCACAACCTT->CCACAACCTTA
GCCACCTAGAG->CCACCTAGAGC
GCCAGACAGAG->CCAGACAGAGG
GCCAGAGCTTT->CCAGAGCTTTT
GCCAGCGGGGT->CCAGCGGGGTC
GCCAGGCACAC->CCAGGCACACT
GCCAGGGCTCC->CCAGGGCTCCA
GCCAGGTCTCG->CCAGGTCTCGT
GCCAGTCACAG->CCAGTCACAGC
GCCATAATAGG->CCATAATAGGG
GCCCACTTTGT->CCCACTTTGTT
GCCCAGTTTCC->CCCAGTTTCCT
GCCCCAAGCAG->CCCCAAGCAGC
GCCCCTTCATT->CCCCTTCATTT
GCCCGGTCCTA->CCCGGTCCTAG
GCCCGTCGCGG->CCCGTCGCGGC
GCCCTATATAT->CCCTATATATA
GCCCTGAGCAT->CCCTGAGCATA
GCCCTTGTAGG->CCCTTGTAGGC
GCCGAAATGGC->CCGAAATGGCT
GCCGAGCATGT->CCGAGCATGTA
GCCGCCCGTCG->CCGCCCGTCGC
GCCGCTAAGGT->CCGCTAAGGTC
GCCGGTAGGCT->CCGGTAGGCTT
GCCGTAAATCC->CCGTAAATCCG
GCCTAAACATC->CCTAAACATCA
GCCTATTACTA->CCTATTACTAG
GCCTCACGATT->CCTCACGATTC
GCCTCCGTCTT->CCTCCGTCTTC
GCCTGGGCTCC->CCTGGGCTCCC
GCCTGTGGCGA->CCTGTGGCGAC
GCCTTGCCGAA->CCTTGCCGAAA
GCCTTTATCTA->CCTTTATCTAC
GCCTTTTATCC->CCTTTTATCCC
GCGAACTCCTG->CGAACTCCTGA
GCGAAGTCGCT->CGAAGTCGCTG
GCGACCCTGCT->CGACCCTGCTG
GCGACTATTTT->CGACTATTTTA
GCGATACCAAG->CGATACCAAGT
GCGCAGGGGCT->CGCAGGGGCTA
GCGCATGCTTG->CGCATGCTTGG
GCGCATTAGGG->CGCATTAGGGC
GCGCCAGACAG->CGCCAGACAGA
GCGCCATAATA->CGCCATAATAG
GCGCCCGGTCC->CGCCCGGTCCT
GCGCCTATTAC->CGCCTATTACT
GCGCGCAGGGG->CGCGCAGGGGC
GCGCGCCAGAC->CGCGCCAGACA
GCGCGGCCGGT->CGCGGCCGGTA
GCGCGTGTTGA->CGCGTGTTGAG
GCGCGTTTTAA->CGCGTTTTAAG
GCGCTCGGACT->CGCTCGGACTA
GCGGCAAAATA->CGGCAAAATAC
GCGGCAATGCA->CGGCAATGCAC
GCGGCCGGTAG->CGGCCGGTAGG
GCGGCGATACC->CGGCGATACCA
GCGGGGTCGCC->CGGGGTCGCCT
GCGGGTGCTGG->CGGGTGCTGGT
GCGGTTCCATC->CGGTTCCATCG
GCGTAGGCACA->CGTAGGCACAG
GCGTGGCCACC->CGTGGCCACCT
GCGTGTTCCCA->CGTGTTCCCAT
GCGTGTTGAGC->CGTGTTGAGCA
GCGTTCTGGAG->CGTTCTGGAGC
GCGTTTGATGG->CGTTTGATGGA
GCGTTTTAAGT->CGTTTTAAGTA
GCTAAAACTTC->CTAAAACTTCA
GCTAACCAGTA->CTAACCAGTAT
GCTAAGGTCCA->CTAAGGTCCAC
GCTAATACATG->CTAATACATGC
GCTACACACCG->CTACACACCGT
GCTACGCGCGG->CTACGCGCGGC
GCTAGCTAACC->CTAGCTAACCA
GCTAGTCATGG->CTAGTCATGGT
GCTATAAGCGG->CTATAAGCGGT
GCTCACTTCTT->CTCACTTCTTC
GCTCCAAACGA->CTCCAAACGAT
GCTCCAGACGG->CTCCAGACGGT
GCTCCCCATTA->CTCCCCATTAA
GCTCCGCAAGA->CTCCGCAAGAC
GCTCCGCTTGG->CTCCGCTTGGG
GCTCGGACTAG->CTCGGACTAGC
GCTCGGATTGC->CTCGGATTGCG
GCTCTACTCGA->CTCTACTCGAT
GCTCTCCCATG->CTCTCCCATGC
GCTGAACTTCA->CTGAACTTCAA
GCTGACATTCC->CTGACATTCCG
GCTGCAATTTC->CTGCAATTTCC
GCTGGCGCGTG->CTGGCGCGTGT
GCTGGTTCGCT->CTGGTTCGCTC
GCTTATCCTGG->CTTATCCTGGT
GCTTGGACATT->CTTGGACATTT
GCTTGGGTGGG->CTTGGGTGGGA
GCTTTAGCTAG->CTTTAGCTAGT
GCTTTTTCCCG->CTTTTTCCCGG
GCTTTTTGTTT->CTTTTTGTTTC
GGAACAAGCGA->GAACAAGCGAC
GGAACAGCGTT->GAACAGCGTTC
GGAACGTGCGA->GAACGTGCGAA
GGAACTCTTAC->GAACTCTTACT
GGAAGCATGTG->GAAGCATGTGT
GGAAGGGACTC->GAAGGGACTCT
GGAATGGATCT->GAATGGATCTG
GGACACCTCTT->GACACCTCTTG
GGACATTTTCT->GACATTTTCTA
GGACCTCGACT->GACCTCGACTT
GGACGACCCAG->GACGACCCAGC
GGACTAGCCTG->GACTAGCCTGT
GGACTCTGAGT->GACTCTGAGTA
GGAGCCGCCCG->GAGCCGCCCGT
GGAGCTCTACT->GAGCTCTACTC
GGAGGTGGAGC->GAGGTGGAGCT
GGAGGTTTCTC->GAGGTTTCTCC
GGATAACGTAT->GATAACGTATG
GGATAAGAGGA->GATAAGAGGAC
GGATAATATCA->GATAATATCAA
GGATCATTGCA->GATCATTGCAC
GGATCTACACA->GATCTACACAC
GGATCTCTTGG->GATCTCTTGGA
GGATCTGCGCC->GATCTGCGCCT
GGATGGCCCCA->GATGGCCCCAA
GGATGTGAGTG->GATGTGAGTGA
GGATTACTAGG->GATTACTAGGC
GGATTATATAA->GATTATATAAA
GGATTATCGCC->GATTATCGCCC
GGATTGCGAAG->GATTGCGAAGT
GGCAAAATACC->GCAAAATACCC
GGCAAGCCCTT->GCAAGCCCTTG
GGCAAGTGGGA->GCAAGTGGGAT
GGCAATGCACG->GCAATGCACGA
GGCAATTCCTA->GCAATTCCTAA
GGCACACTGAT->GCACACTGATA
GGCACAGCAGG->GCACAGCAGGA
GGCAGTCTCCC->GCAGTCTCCCA
GGCCACCTAGA->GCCACCTAGAG
GGCCAGGGCTC->GCCAGGGCTCC
GGCCAGTCACA->GCCAGTCACAG
GGCCCCAAGCA->GCCCCAAGCAG
GGCCGGTAGGC->GCCGGTAGGCT
GGCCTAAACAT->GCCTAAACATC
GGCCTCACGAT->GCCTCACGATT
GGCCTCCGTCT->GCCTCCGTCTT
GGCCTTTTATC->GCCTTTTATCC
GGCGACTATTT->GCGACTATTTT
GGCGATACCAA->GCGATACCAAG
GGCGCGTGTTG->GCGCGTGTTGA
GGCGCTCGGAC->GCGCTCGGACT
GGCTAAAACTT->GCTAAAACTTC
GGCTAATACAT->GCTAATACATG
GGCTCCAGACG->GCTCCAGACGG
GGCTCCCCATT->GCTCCCCATTA
GGCTCCGCTTG->GCTCCGCTTGG
GGCTTATCCTG->GCTTATCCTGG
GGCTTTAGCTA->GCTTTAGCTAG
GGCTTTTTGTT->GCTTTTTGTTT
GGGAACAGCGT->GGAACAGCGTT
GGGAACGTGCG->GGAACGTGCGA
GGGAACTCTTA->GGAACTCTTAC
GGGAAGCATGT->GGAAGCATGTG
GGGAAGGGACT->GGAAGGGACTC
GGGACTCTGAG->GGACTCTGAGT
GGGATAAGAGG->GGATAAGAGGA
GGGATGGCCCC->GGATGGCCCCA
GGGATTATATA->GGATTATATAA
GGGCAAGCCCT->GGCAAGCCCTT
GGGCTAAAACT->GGCTAAAACTT
GGGCTAATACA->GGCTAATACAT
GGGCTCCAGAC->GGCTCCAGACG
GGGCTCCCCAT->GGCTCCCCATT
GGGCTCCGCTT->GGCTCCGCTTG
GGGGAACAGCG->GGGAACAGCGT
GGGGCTAATAC->GGGCTAATACA
GGGGGTTGCAC->GGGGTTGCACG
GGGGTATTTCG->GGGTATTTCGA
GGGGTCGCCTT->GGGTCGCCTTG
GGGGTTGCACG->GGGTTGCACGG
GGGTATTTCGA->GGTATTTCGAT
GGGTCGCCTTG->GGTCGCCTTGC
GGGTGCTGGTT->GGTGCTGGTTC
GGGTGGGAACT->GGTGGGAACTC
GGGTGGGATGG->GGTGGGATGGC
GGGTTAATAGA->GGTTAATAGAA
GGGTTGCACGG->GGTTGCACGGC
GGGTTTACGTA->GGTTTACGTAA
GGTAGATACTA->GTAGATACTAC
GGTAGGCTTTT->GTAGGCTTTTT
GGTATTATTCT->GTATTATTCTC
GGTATTTCGAT->GTATTTCGATA
GGTCCACAGAT->GTCCACAGATG
GGTCCTAGAAG->GTCCTAGAAGC
GGTCGCCTTGC->GTCGCCTTGCC
GGTCGCGCCAT->GTCGCGCCATA
GGTCTCGTGGT->GTCTCGTGGTG
GGTCTGCGGGT->GTCTGCGGGTG
GGTGCACAACA->GTGCACAACAT
GGTGCTGGTTC->GTGCTGGTTCG
GGTGGAGCTCT->GTGGAGCTCTA
GGTGGGAACTC->GTGGGAACTCT
GGTGGGATGGC->GTGGGATGGCC
GGTGGTAGATA->GTGGTAGATAC
GGTGGTCGCGC->GTGGTCGCGCC
GGTGTTTGATT->GTGTTTGATTG
GGTTAATAGAA->GTTAATAGAAG
GGTTCACGTGT->GTTCACGTGTT
GGTTCCATCGA->GTTCCATCGAC
GGTTCCTGTAA->GTTCCTGTAAC
GGTTCGCTCAC->GTTCGCTCACT
GGTTGCACGGC->GTTGCACGGCC
GGTTTACGTAA->GTTTACGTAAG
GGTTTCTCCTC->GTTTCTCCTCC
GGTTTGGGATT->GTTTGGGATTA
GGTTTGTCCCG->GTTTGTCCCGG
GGTTTTGCCCA->GTTTTGCCCAG
GTAAAAGGATG->TAAAAGGATGT
GTAAATCCGCC->TAAATCCGCCA
GTAACACTGTA->TAACACTGTAC
GTAACGACCTC->TAACGACCTCC
GTAAGCAGTCC->TAAGCAGTCCA
GTACCGAGAGC->TACCGAGAGCC
GTACCTGCTGC->TACCTGCTGCA
GTACTCTGAAC->TACTCTGAACA
GTACTTTGACG->TACTTTGACGC
GTACTTTGGCC->TACTTTGGCCT
GTAGACCTCTT->TAGACCTCTTG
GTAGATACTAC->TAGATACTACT
GTAGGCACAGC->TAGGCACAGCA
GTAGGCCTCAC->TAGGCCTCACG
GTAGGCTTTTT->TAGGCTTTTTG
GTAGTGAACAC->TAGTGAACACG
GTAGTGGGGGT->TAGTGGGGGTT
GTATCTCACTA->TATCTCACTAT
GTATGGTGGTA->TATGGTGGTAG
GTATGTTCATA->TATGTTCATAA
GTATTAAGATT->TATTAAGATTG
GTATTATTCTC->TATTATTCTCA
GTATTTCGATA->TATTTCGATAT
GTATTTCGCTC->TATTTCGCTCT
GTCACAGCGCA->TCACAGCGCAT
GTCACCGACAT->TCACCGACATT
GTCAGGCAAGT->TCAGGCAAGTG
GTCATGGTTTG->TCATGGTTTGG
GTCCAAGGCCA->TCCAAGGCCAG
GTCCACAGATG->TCCACAGATGT
GTCCCGGAGGT->TCCCGGAGGTT
GTCCTAGAAGC->TCCTAGAAGCA
GTCGCCTTGCC->TCGCCTTGCCG
GTCGCGCCATA->TCGCGCCATAA
GTCGCGGCAAA->TCGCGGCAAAA
GTCGCTGGCGC->TCGCTGGCGCG
GTCTCCCAGGG->TCTCCCAGGGG
GTCTCGTGGTG->TCTCGTGGTGC
GTCTGCGGGTG->TCTGCGGGTGC
GTCTTCAGTTC->TCTTCAGTTCA
GTCTTCGCCAA->TCTTCGCCAAG
GTCTTTGGACA->TCTTTGGACAC
GTGAACACGAC->TGAACACGACG
GTGAATTGTCA->TGAATTGTCAG
GTGAGTGATGG->TGAGTGATGGG
GTGATCCGCTA->TGATCCGCTAT
GTGATGGGTGG->TGATGGGTGGG
GTGCAATACTA->TGCAATACTAC
GTGCACAACAT->TGCACAACATT
GTGCGAACTCC->TGCGAACTCCT
GTGCTACGCGC->TGCTACGCGCG
GTGCTAGCTAA->TGCTAGCTAAC
GTGCTGGTTCG->TGCTGGTTCGC
GTGGAGCTCTA->TGGAGCTCTAC
GTGGATCATTG->TGGATCATTGC
GTGGCCACCTA->TGGCCACCTAG
GTGGCGACTAT->TGGCGACTATT
GTGGCTTATCC->TGGCTTATCCT
GTGGGAACTCT->TGGGAACTCTT
GTGGGATAAGA->TGGGATAAGAG
GTGGGATGGCC->TGGGATGGCCC
GTGGGGGTTGC->TGGGGGTTGCA
GTGGTAGATAC->TGGTAGATACT
GTGGTCGCGCC->TGGTCGCGCCA
GTGGTGCACAA->TGGTGCACAAC
GTGGTTTTGCC->TGGTTTTGCCC
GTGTACCGAGA->TGTACCGAGAG
GTGTACCTGCT->TGTACCTGCTG
GTGTTCCCATT->TGTTCCCATTG
GTGTTGAAGCC->TGTTGAAGCCC
GTGTTGAGCAG->TGTTGAGCAGA
GTGTTTGATTG->TGTTTGATTGA
GTTAAAAGTGG->TTAAAAGTGGA
GTTAATAGAAG->TTAATAGAAGA
GTTACGTGGTT->TTACGTGGTTT
GTTCAAAACTC->TTCAAAACTCG
GTTCAATTAGG->TTCAATTAGGT
GTTCACGTGTT->TTCACGTGTTG
GTTCAGTGTAC->TTCAGTGTACC
GTTCATAAACA->TTCATAAACAC
GTTCCATCGAC->TTCCATCGACT
GTTCCCATTGG->TTCCCATTGGT
GTTCCTGTAAC->TTCCTGTAACG
GTTCGCTCACT->TTCGCTCACTT
GTTCTCCTTGC->TTCTCCTTGCC
GTTCTGGAGCC->TTCTGGAGCCG
GTTGAAGCCCT->TTGAAGCCCTA
GTTGAGCAGAT->TTGAGCAGATC
GTTGCACGGCC->TTGCACGGCCT
GTTGGCAGTCT->TTGGCAGTCTC
GTTGTTCAGTG->TTGTTCAGTGT
GTTTACGTAAG->TTTACGTAAGC
GTTTCCTTCCC->TTTCCTTCCCC
GTTTCGACAAG->TTTCGACAAGT
GTTTCTCCTCC->TTTCTCCTCCG
GTTTCTTATGA->TTTCTTATGAG
GTTTGATGGAT->TTTGATGGATC
GTTTGATTGAG->TTTGATTGAGA
GTTTGGGATTA->TTTGGGATTAT
GTTTGTCCCGG->TTTGTCCCGGA
GTTTTAAGTAG->TTTTAAGTAGT
GTTTTGCCCAG->TTTTGCCCAGT
TAAAACTTCAT->AAAACTTCATG
TAAAAGGATGT->AAAAGGATGTG
TAAAAGTGGAT->AAAAGTGGATC
TAAACACCTTG->AAACACCTTGC
TAAACATCATT->AAACATCATTG
TAAACATGTTC->AAACATGTTCT
TAAAGAGACTT->AAAGAGACTTA
TAAATCCGCCA->AAATCCGCCAG
TAAATGCCCAC->AAATGCCCACT
TAAATTGCGCG->AAATTGCGCGT
TAACACTGTAC->AACACTGTACT
TAACAGGGAAC->AACAGGGAACG
TAACCAGTATC->AACCAGTATCT
TAACGACCTCC->AACGACCTCCA
TAACGCACCTG->AACGCACCTGA
TAACGTATGGT->AACGTATGGTG
TAACTTGATCT->AACTTGATCTT
TAAGAGGACCT->AAGAGGACCTC
TAAGATTGTGA->AAGATTGTGAT
TAAGCAGTCCA->AAGCAGTCCAA
TAAGCGGTTCC->AAGCGGTTCCA
TAAGGGGAACA->AAGGGGAACAG
TAAGGTCCACA->AAGGTCCACAG
TAAGGTGTTTG->AAGGTGTTTGA
TAAGTAGTGAA->AAGTAGTGAAC
TAATAATACAA->AATAATACAAG
TAATACAAGCT->AATACAAGCTC
TAATACATGCG->AATACATGCGT
TAATAGAAGAG->AATAGAAGAGG
TAATAGGGTTT->AATAGGGTTTA
TAATATCAACT->AATATCAACTT
TAATATTAGAG->AATATTAGAGT
TAATCGCCGTA->AATCGCCGTAA
TAATGCTACAC->AATGCTACACA
TAATGTGCTAC->AATGTGCTACG
TACAAGCTCCA->ACAAGCTCCAA
TACACACAACG->ACACACAACGG
TACACACCGTA->ACACACCGTAA
TACAGACGCAT->ACAGACGCATA
TACATCCAACC->ACATCCAACCG
TACATCCTTCT->ACATCCTTCTC
TACATGCGTGG->ACATGCGTGGC
TACCAAGTAGA->ACCAAGTAGAC
TACCCGCGTAG->ACCCGCGTAGG
TACCCTTCATG->ACCCTTCATGC
TACCGAGAGCC->ACCGAGAGCCA
TACCTGCTGCA->ACCTGCTGCAA
TACGCGCGGCC->ACGCGCGGCCG
TACGGCGCTCG->ACGGCGCTCGG
TACGTAAGCAG->ACGTAAGCAGT
TACGTGGTTTT->ACGTGGTTTTG
TACTACAGACG->ACTACAGACGC
TACTACTAGAC->ACTACTAGACG
TACTAGACGCA->ACTAGACGCAT
TACTAGGCAAT->ACTAGGCAATT
TACTAGTGCAA->ACTAGTGCAAT
TACTCATTTAA->ACTCATTTAAT
TACTCGATTGC->ACTCGATTGCT
TACTCGCATTG->ACTCGCATTGC
TACTCTGAACA->ACTCTGAACAG
TACTGAACGAG->ACTGAACGAGC
TACTGAGAGAT->ACTGAGAGATT
TACTGTAGTGG->ACTGTAGTGGG
TACTTTGACGC->ACTTTGACGCG
TACTTTGGCCT->ACTTTGGCCTC
TAGAAAACGCA->AGAAAACGCAT
TAGAACAATAC->AGAACAATACC
TAGAACCTCTG->AGAACCTCTGG
TAGAAGAGGGA->AGAAGAGGGAA
TAGAAGCATAG->AGAAGCATAGA
TAGACCTCTTG->AGACCTCTTGG
TAGACGCATCC->AGACGCATCCA
TAGAGCGCCCG->AGAGCGCCCGG
TAGAGTCTTCG->AGAGTCTTCGC
TAGATACTACT->AGATACTACTA
TAGATGTCTTT->AGATGTCTTTG
TAGCCGCTAAG->AGCCGCTAAGG
TAGCCTGTGGC->AGCCTGTGGCG
TAGCGCATGCT->AGCGCATGCTT
TAGCTAACCAG->AGCTAACCAGT
TAGCTAGTCAT->AGCTAGTCATG
TAGGCAATTCC->AGGCAATTCCT
TAGGCACAGCA->AGGCACAGCAG
TAGGCCTCACG->AGGCCTCACGA
TAGGCTTTTTG->AGGCTTTTTGT
TAGGGCAAGCC->AGGGCAAGCCC
TAGGGTTTACG->AGGGTTTACGT
TAGGTATTATT->AGGTATTATTC
TAGGTGGTCGC->AGGTGGTCGCG
TAGTACTCTGA->AGTACTCTGAA
TAGTCATGGTT->AGTCATGGTTT
TAGTGAACACG->AGTGAACACGA
TAGTGCAATAC->AGTGCAATACT
TAGTGGGGGTT->AGTGGGGGTTG
TATAAAGAGAC->ATAAAGAGACT
TATAAATGCCC->ATAAATGCCCA
TATAAATTGCG->ATAAATTGCGC
TATAAGCGGTT->ATAAGCGGTTC
TATACTGTAGT->ATACTGTAGTG
TATAGAACAAT->ATAGAACAATA
TATAGTACTCT->ATAGTACTCTG
TATATAAATGC->ATATAAATGCC
TATATATATGT->ATATATATGTG
TATATATGTGA->ATATATGTGAA
TATATGCACAC->ATATGCACACT
TATATGTGAAT->ATATGTGAATT
TATCAACTTTA->ATCAACTTTAG
TATCCCGACCG->ATCCCGACCGA
TATCCTGGTCT->ATCCTGGTCTG
TATCGCCCCTT->ATCGCCCCTTC
TATCTACTGAA->ATCTACTGAAC
TATCTCACTAT->ATCTCACTATA
TATGAGGAATG->ATGAGGAATGG
TATGCACACTT->ATGCACACTTT
TATGGTGGTAG->ATGGTGGTAGA
TATGTGAATTG->ATGTGAATTGT
TATGTTCATAA->ATGTTCATAAA
TATTAAGATTG->ATTAAGATTGT
TATTACTAGTG->ATTACTAGTGC
TATTAGAGTCT->ATTAGAGTCTT
TATTATTCTCA->ATTATTCTCAC
TATTCTCACTA->ATTCTCACTAT
TATTTCGATAT->ATTTCGATATA
TATTTCGCTCT->ATTTCGCTCTC
TATTTTAAGGT->ATTTTAAGGTG
TCAAAACTCGA->CAAAACTCGAG
TCAACTTTAGA->CAACTTTAGAA
TCAATGAGTGG->CAATGAGTGGC
TCAATGGTTCA->CAATGGTTCAC
TCAATTAGGTG->CAATTAGGTGG
TCACAGCGCAT->CACAGCGCATT
TCACCAGAGTT->CACCAGAGTTA
TCACCGACATT->CACCGACATTG
TCACCTAAACA->CACCTAAACAT
TCACGATTCTC->CACGATTCTCT
TCACGTGTTGA->CACGTGTTGAA
TCACTATAAAT->CACTATAAATT
TCACTATACTG->CACTATACTGT
TCACTTCTTCC->CACTTCTTCCT
TCAGGCAAGTG->CAGGCAAGTGG
TCAGTGTACCT->CAGTGTACCTG
TCAGTTCAATT->CAGTTCAATTA
TCATAAACACC->CATAAACACCT
TCATGCAGTTG->CATGCAGTTGG
TCATGCCTGGG->CATGCCTGGGC
TCATGGTTTGG->CATGGTTTGGG
TCATTGCACAT->CATTGCACATG
TCATTGCTCCG->CATTGCTCCGC
TCATTTAATAA->CATTTAATAAT
TCATTTCCGAT->CATTTCCGATA
TCCAAACGATT->CCAAACGATTG
TCCAACCGTGC->CCAACCGTGCT
TCCAAGGCCAG->CCAAGGCCAGT,CCAAGGCCAGG
TCCACAGATGT->CCACAGATGTT
TCCACCAGTAT->CCACCAGTATT
TCCAGACGGTT->CCAGACGGTTT
TCCATCCAAGG->CCATCCAAGGC
TCCATCGACTA->CCATCGACTAT
TCCCAGGGGTA->CCCAGGGGTAT
TCCCATGCAAA->CCCATGCAAAG
TCCCATTGGTT->CCCATTGGTTC
TCCCCATTAAG->CCCCATTAAGG
TCCCCTGCGGC->CCCCTGCGGCG
TCCCCTTTAGC->CCCCTTTAGCG
TCCCGACCGAC->CCCGACCGACC
TCCCGACGCAT->CCCGACGCATC
TCCCGGAGGTT->CCCGGAGGTTT
TCCCGGATTAC->CCCGGATTACT
TCCCTTCTGCC->CCCTTCTGCCG
TCCGATAACGC->CCGATAACGCA
TCCGATCTTGT->CCGATCTTGTT
TCCGATGAACC->CCGATGAACCA
TCCGCAAGACA->CCGCAAGACAT
TCCGCACGAAT->CCGCACGAATT
TCCGCCAGCGG->CCGCCAGCGGG
TCCGCTATAAG->CCGCTATAAGC
TCCGCTTGGGT->CCGCTTGGGTG
TCCGTCTTCAG->CCGTCTTCAGT
TCCTAACTTGA->CCTAACTTGAT
TCCTAGAAGCA->CCTAGAAGCAT
TCCTATATGCA->CCTATATGCAC
TCCTCCGATCT->CCTCCGATCTT
TCCTGAGGAGG->CCTGAGGAGGT
TCCTGGTCTGC->CCTGGTCTGCG
TCCTGTAACGA->CCTGTAACGAC
TCCTTACATCC->CCTTACATCCA
TCCTTCCCCTG->CCTTCCCCTGC
TCCTTCTCCCT->CCTTCTCCCTT
TCCTTGCCAGA->CCTTGCCAGAG
TCGACAAGTAA->CGACAAGTAAA
TCGACTATAGA->CGACTATAGAA
TCGACTTAATG->CGACTTAATGT
TCGAGAGGCCT->CGAGAGGCCTA
TCGATATAGTA->CGATATAGTAC
TCGATTGCTGA->CGATTGCTGAC
TCGCATTGCAA->CGCATTGCAAC
TCGCCAAGAGC->CGCCAAGAGCA
TCGCCCCTTCA->CGCCCCTTCAT
TCGCCGTAAAT->CGCCGTAAATC
TCGCCTTGCCG->CGCCTTGCCGA
TCGCGCCATAA->CGCGCCATAAT
TCGCGGCAAAA->CGCGGCAAAAT
TCGCTCACTTC->CGCTCACTTCT
TCGCTCTCCCA->CGCTCTCCCAT
TCGCTGGCGCG->CGCTGGCGCGT
TCGGACTAGCC->CGGACTAGCCT
TCGGATTGCGA->CGGATTGCGAA
TCGTGGTGCAC->CGTGGTGCACA
TCTACACACAA->CTACACACAAC
TCTACTCATTT->CTACTCATTTA
TCTACTCGATT->CTACTCGATTG
TCTACTGAACG->CTACTGAACGA
TCTAGATGTCT->CTAGATGTCTT
TCTAGGTATTA->CTAGGTATTAT
TCTCACTATAA->CTCACTATAAA
TCTCACTATAC->CTCACTATACT
TCTCCCAGGGG->CTCCCAGGGGT
TCTCCCATGCA->CTCCCATGCAA
TCTCCCTTCTG->CTCCCTTCTGC
TCTCCTCCGAT->CTCCTCCGATC
TCTCCTTGCCA->CTCCTTGCCAG
TCTCGTGGTGC->CTCGTGGTGCA
TCTCTAGGTAT->CTCTAGGTATT
TCTCTTGGAAC->CTCTTGGAACA
TCTGAACAGAA->CTGAACAGAAC
TCTGAGTATGT->CTGAGTATGTT
TCTGCCGAGCA->CTGCCGAGCAT
TCTGCGCCTAT->CTGCGCCTATT
TCTGCGGGTGC->CTGCGGGTGCT
TCTGGACGACC->CTGGACGACCC
TCTGGAGCCGC->CTGGAGCCGCC
TCTGTCACCGA->CTGTCACCGAC
TCTTACTCGCA->CTTACTCGCAT
TCTTATGAGGA->CTTATGAGGAA
TCTTCAGTTCA->CTTCAGTTCAA
TCTTCCTATAT->CTTCCTATATG
TCTTCGCCAAG->CTTCGCCAAGA
TCTTGCCCTGA->CTTGCCCTGAG
TCTTGGAACAA->CTTGGAACAAG
TCTTGGATTAT->CTTGGATTATC
TCTTGTTAAAA->CTTGTTAAAAG
TCTTTCCGCAC->CTTTCCGCACG
TCTTTGGACAC->CTTTGGACACC
TGAACACGACG->GAACACGACGC
TGAACAGAACG->GAACAGAACGA
TGAACCATCAC->GAACCATCACC
TGAACGAGCAC->GAACGAGCACG
TGAACTTCAAT->GAACTTCAATG
TGAAGCCCTAT->GAAGCCCTATA
TGAATTGTCAG->GAATTGTCAGG
TGACATTCCGA->GACATTCCGAT
TGACGCGCGCA->GACGCGCGCAG
TGAGAGATTAT->GAGAGATTATA
TGAGATCCCGA->GAGATCCCGAC
TGAGCAGATCT->GAGCAGATCTG
TGAGCATACTG->GAGCATACTGA
TGAGGAATGGA->GAGGAATGGAT
TGAGGAGGTGG->GAGGAGGTGGA
TGAGTATGTTC->GAGTATGTTCA
TGAGTGATGGG->GAGTGATGGGT
TGAGTGGCTTA->GAGTGGCTTAT
TGATAATATTA->GATAATATTAG
TGATCCGCTAT->GATCCGCTATA
TGATCTTTCCG->GATCTTTCCGC
TGATGCGTTTG->GATGCGTTTGA
TGATGGATCTC->GATGGATCTCT
TGATGGGTGGG->GATGGGTGGGA
TGATTGAGATC->GATTGAGATCC
TGCAAAGTATT->GCAAAGTATTA
TGCAACTTGGG->GCAACTTGGGT
TGCAATACTAC->GCAATACTACA
TGCAATTTCCT->GCAATTTCCTT
TGCACAACATT->GCACAACATTC
TGCACATGCCA->GCACATGCCAG
TGCACGAGGAT->GCACGAGGATA
TGCACGGCCTT->GCACGGCCTTT
TGCAGTTGGCA->GCAGTTGGCAG
TGCATACATCC->GCATACATCCT
TGCCAGAGCTT->GCCAGAGCTTT
TGCCAGGCACA->GCCAGGCACAC
TGCCCACTTTG->GCCCACTTTGT
TGCCCAGTTTC->GCCCAGTTTCC
TGCCCTGAGCA->GCCCTGAGCAT
TGCCGAAATGG->GCCGAAATGGC
TGCCGAGCATG->GCCGAGCATGT
TGCCTGGGCTC->GCCTGGGCTCC
TGCGAACTCCT->GCGAACTCCTG
TGCGAAGTCGC->GCGAAGTCGCT
TGCGCCTATTA->GCGCCTATTAC
TGCGCGTTTTA->GCGCGTTTTAA
TGCGGCAATGC->GCGGCAATGCA
TGCGGCGATAC->GCGGCGATACC
TGCGGGTGCTG->GCGGGTGCTGG
TGCGTGGCCAC->GCGTGGCCACC
TGCGTGTTCCC->GCGTGTTCCCA
TGCGTTTGATG->GCGTTTGATGG
TGCTACACACC->GCTACACACCG
TGCTACGCGCG->GCTACGCGCGG
TGCTAGCTAAC->GCTAGCTAACC
TGCTCCGCAAG->GCTCCGCAAGA
TGCTCGGATTG->GCTCGGATTGC
TGCTGAACTTC->GCTGAACTTCA
TGCTGACATTC->GCTGACATTCC
TGCTGCAATTT->GCTGCAATTTC
TGCTGGTTCGC->GCTGGTTCGCT
TGCTTGGACAT->GCTTGGACATT
TGGAACAAGCG->GGAACAAGCGA
TGGACACCTCT->GGACACCTCTT
TGGACATTTTC->GGACATTTTCT
TGGACGACCCA->GGACGACCCAG
TGGAGCCGCCC->GGAGCCGCCCG
TGGAGCTCTAC->GGAGCTCTACT
TGGATCATTGC->GGATCATTGCA
TGGATCTCTTG->GGATCTCTTGG
TGGATCTGCGC->GGATCTGCGCC
TGGATTATCGC->GGATTATCGCC
TGGCAGTCTCC->GGCAGTCTCCC
TGGCCACCTAG->GGCCACCTAGA
TGGCCCCAAGC->GGCCCCAAGCA
TGGCCTCCGTC->GGCCTCCGTCT
TGGCGACTATT->GGCGACTATTT
TGGCGCGTGTT->GGCGCGTGTTG
TGGCTTATCCT->GGCTTATCCTG
TGGCTTTAGCT->GGCTTTAGCTA
TGGGAACTCTT->GGGAACTCTTA
TGGGAAGCATG->GGGAAGCATGT
TGGGATAAGAG->GGGATAAGAGG
TGGGATGGCCC->GGGATGGCCCC
TGGGATTATAT->GGGATTATATA
TGGGCTCCCCA->GGGCTCCCCAT
TGGGCTCCGCT->GGGCTCCGCTT
TGGGGGTTGCA->GGGGGTTGCAC
TGGGTGGGAAC->GGGTGGGAACT
TGGGTGGGATG->GGGTGGGATGG
TGGGTTAATAG->GGGTTAATAGA
TGGTAGATACT->GGTAGATACTA
TGGTCGCGCCA->GGTCGCGCCAT
TGGTCTGCGGG->GGTCTGCGGGT
TGGTGCACAAC->GGTGCACAACA
TGGTGGTAGAT->GGTGGTAGATA
TGGTTCACGTG->GGTTCACGTGT
TGGTTCCTGTA->GGTTCCTGTAA
TGGTTCGCTCA->GGTTCGCTCAC
TGGTTTGGGAT->GGTTTGGGATT
TGGTTTTGCCC->GGTTTTGCCCA
TGTAACGACCT->GTAACGACCTC
TGTACCGAGAG->GTACCGAGAGC
TGTACCTGCTG->GTACCTGCTGC
TGTACTTTGAC->GTACTTTGACG
TGTACTTTGGC->GTACTTTGGCC
TGTAGGCCTCA->GTAGGCCTCAC
TGTAGTGGGGG->GTAGTGGGGGT
TGTCACCGACA->GTCACCGACAT
TGTCAGGCAAG->GTCAGGCAAGT
TGTCCCGGAGG->GTCCCGGAGGT
TGTCTTTGGAC->GTCTTTGGACA
TGTGAATTGTC->GTGAATTGTCA
TGTGAGTGATG->GTGAGTGATGG
TGTGATCCGCT->GTGATCCGCTA
TGTGCTACGCG->GTGCTACGCGC
TGTGGCGACTA->GTGGCGACTAT
TGTGTACCGAG->GTGTACCGAGA
TGTTAAAAGTG->GTTAAAAGTGG
TGTTCAAAACT->GTTCAAAACTC
TGTTCAGTGTA->GTTCAGTGTAC
TGTTCATAAAC->GTTCATAAACA
TGTTCCCATTG->GTTCCCATTGG
TGTTCTCCTTG->GTTCTCCTTGC
TGTTGAAGCCC->GTTGAAGCCCT
TGTTGAGCAGA->GTTGAGCAGAT
TGTTGTTCAGT->GTTGTTCAGTG
TGTTTCGACAA->GTTTCGACAAG
TGTTTGATTGA->GTTTGATTGAG
TTAAAAGTGGA->TAAAAGTGGAT
TTAACAGGGAA->TAACAGGGAAC
TTAAGATTGTG->TAAGATTGTGA
TTAAGGGGAAC->TAAGGGGAACA
TTAAGGTGTTT->TAAGGTGTTTG
TTAAGTAGTGA->TAAGTAGTGAA
TTAATAATACA->TAATAATACAA
TTAATAGAAGA->TAATAGAAGAG
TTAATCGCCGT->TAATCGCCGTA
TTAATGTGCTA->TAATGTGCTAC
TTACATCCAAC->TACATCCAACC
TTACGGCGCTC->TACGGCGCTCG
TTACGTAAGCA->TACGTAAGCAG
TTACGTGGTTT->TACGTGGTTTT
TTACTAGGCAA->TACTAGGCAAT
TTACTAGTGCA->TACTAGTGCAA
TTACTCGCATT->TACTCGCATTG
TTAGAACCTCT->TAGAACCTCTG
TTAGAGTCTTC->TAGAGTCTTCG
TTAGCGCATGC->TAGCGCATGCT
TTAGCTAGTCA->TAGCTAGTCAT
TTAGGGCAAGC->TAGGGCAAGCC
TTAGGTGGTCG->TAGGTGGTCGC
TTATAAAGAGA->TATAAAGAGAC
TTATATAAATG->TATATAAATGC
TTATCCCGACC->TATCCCGACCG
TTATCCTGGTC->TATCCTGGTCT
TTATCGCCCCT->TATCGCCCCTT
TTATCTACTGA->TATCTACTGAA
TTATGAGGAAT->TATGAGGAATG
TTATTCTCACT->TATTCTCACTA
TTCAAAACTCG->TCAAAACTCGA
TTCAATGGTTC->TCAATGGTTCA
TTCAATTAGGT->TCAATTAGGTG
TTCACCTAAAC->TCACCTAAACA
TTCACGTGTTG->TCACGTGTTGA
TTCAGTGTACC->TCAGTGTACCT
TTCAGTTCAAT->TCAGTTCAATT
TTCATAAACAC->TCATAAACACC
TTCATGCAGTT->TCATGCAGTTG
TTCATGCCTGG->TCATGCCTGGG
TTCATTTCCGA->TCATTTCCGAT
TTCCATCGACT->TCCATCGACTA
TTCCCATTGGT->TCCCATTGGTT
TTCCCCTGCGG->TCCCCTGCGGC
TTCCCGGATTA->TCCCGGATTAC
TTCCGATAACG->TCCGATAACGC
TTCCGATGAAC->TCCGATGAACC
TTCCGCACGAA->TCCGCACGAAT
TTCCTAACTTG->TCCTAACTTGA
TTCCTATATGC->TCCTATATGCA
TTCCTGTAACG->TCCTGTAACGA
TTCCTTACATC->TCCTTACATCC
TTCCTTCCCCT->TCCTTCCCCTG
TTCGACAAGTA->TCGACAAGTAA
TTCGATATAGT->TCGATATAGTA
TTCGCCAAGAG->TCGCCAAGAGC
TTCGCTCACTT->TCGCTCACTTC
TTCGCTCTCCC->TCGCTCTCCCA
TTCTACTCATT->TCTACTCATTT
TTCTAGATGTC->TCTAGATGTCT
TTCTCACTATA->TCTCACTATAC
TTCTCCCTTCT->TCTCCCTTCTG
TTCTCCTCCGA->TCTCCTCCGAT
TTCTCCTTGCC->TCTCCTTGCCA
TTCTCTAGGTA->TCTCTAGGTAT
TTCTGCCGAGC->TCTGCCGAGCA
TTCTGGAGCCG->TCTGGAGCCGC
TTCTTATGAGG->TCTTATGAGGA
TTCTTCCTATA->TCTTCCTATAT
TTGAAGCCCTA->TGAAGCCCTAT
TTGACGCGCGC->TGACGCGCGCA
TTGAGATCCCG->TGAGATCCCGA
TTGAGCAGATC->TGAGCAGATCT
TTGATCTTTCC->TGATCTTTCCG
TTGATGGATCT->TGATGGATCTC
TTGATTGAGAT->TGATTGAGATC
TTGCAACTTGG->TGCAACTTGGG
TTGCACATGCC->TGCACATGCCA
TTGCACGGCCT->TGCACGGCCTT
TTGCATACATC->TGCATACATCC
TTGCCAGAGCT->TGCCAGAGCTT
TTGCCCAGTTT->TGCCCAGTTTC
TTGCCCTGAGC->TGCCCTGAGCA
TTGCCGAAATG->TGCCGAAATGG
TTGCGAAGTCG->TGCGAAGTCGC
TTGCGCGTTTT->TGCGCGTTTTA
TTGCGGCAATG->TGCGGCAATGC
TTGCGTGTTCC->TGCGTGTTCCC
TTGCTCCGCAA->TGCTCCGCAAG
TTGCTGACATT->TGCTGACATTC
TTGGAACAAGC->TGGAACAAGCG
TTGGACACCTC->TGGACACCTCT
TTGGACATTTT->TGGACATTTTC
TTGGATTATCG->TGGATTATCGC
TTGGCAGTCTC->TGGCAGTCTCC
TTGGCCTCCGT->TGGCCTCCGTC
TTGGGATTATA->TGGGATTATAT
TTGGGCTCCGC->TGGGCTCCGCT
TTGGGTGGGAT->TGGGTGGGATG
TTGGGTTAATA->TGGGTTAATAG
TTGGTTCCTGT->TGGTTCCTGTA
TTGTAGGCCTC->TGTAGGCCTCA
TTGTCAGGCAA->TGTCAGGCAAG
TTGTCCCGGAG->TGTCCCGGAGG
TTGTGATCCGC->TGTGATCCGCT
TTGTTAAAAGT->TGTTAAAAGTG
TTGTTCAAAAC->TGTTCAAAACT
TTGTTCAGTGT->TGTTCAGTGTA
TTGTTTCGACA->TGTTTCGACAA
TTTAAGGTGTT->TTAAGGTGTTT
TTTAAGTAGTG->TTAAGTAGTGA
TTTAATAATAC->TTAATAATACA
TTTACGTAAGC->TTACGTAAGCA
TTTAGAACCTC->TTAGAACCTCT
TTTAGCGCATG->TTAGCGCATGC
TTTAGCTAGTC->TTAGCTAGTCA
TTTATCCCGAC->TTATCCCGACC
TTTATCTACTG->TTATCTACTGA
TTTCCCGGATT->TTCCCGGATTA
TTTCCGATAAC->TTCCGATAACG
TTTCCGCACGA->TTCCGCACGAA
TTTCCTTACAT->TTCCTTACATC
TTTCCTTCCCC->TTCCTTCCCCT
TTTCGACAAGT->TTCGACAAGTA
TTTCGATATAG->TTCGATATAGT
TTTCGCTCTCC->TTCGCTCTCCC
TTTCTAGATGT->TTCTAGATGTC
TTTCTCCTCCG->TTCTCCTCCGA
TTTCTTATGAG->TTCTTATGAGG
TTTGACGCGCG->TTGACGCGCGC
TTTGATGGATC->TTGATGGATCT
TTTGATTGAGA->TTGATTGAGAT
TTTGCCCAGTT->TTGCCCAGTTT
TTTGGACACCT->TTGGACACCTC
TTTGGCCTCCG->TTGGCCTCCGT
TTTGGGATTAT->TTGGGATTATA
TTTGTCCCGGA->TTGTCCCGGAG
TTTGTTCAAAA->TTGTTCAAAAC
TTTGTTTCGAC->TTGTTTCGACA
TTTTAAGGTGT->TTTAAGGTGTT
TTTTAAGTAGT->TTTAAGTAGTG
TTTTATCCCGA->TTTATCCCGAC
TTTTCCCGGAT->TTTCCCGGATT
TTTTCTAGATG->TTTCTAGATGT
TTTTGCCCAGT->TTTGCCCAGTT
TTTTGTTTCGA->TTTGTTTCGAC
TTTTTCCCGGA->TTTTCCCGGAT
TTTTTGTTTCG->TTTTGTTTCGA
